Middle layer Super Output Areas Code,Middle layer Super Output Areas,1_not_deprived ,2_one_dimension,3_two_dimensions,4_three_dimensions,5_four_dimensions,total,% deprived
E02000001,City of London 001,2937,1547,347,75,8,4914,40.23199023
E02000002,Barking and Dagenham 001,954,1085,613,194,24,2870,66.75958188
E02000003,Barking and Dagenham 002,1649,1467,667,145,2,3930,58.04071247
E02000004,Barking and Dagenham 003,1014,829,365,98,3,2309,56.08488523
E02000005,Barking and Dagenham 004,1544,1252,620,201,13,3630,57.46556474
E02000007,Barking and Dagenham 006,1335,1320,739,265,16,3675,63.67346939
E02000008,Barking and Dagenham 007,1546,1729,1017,306,26,4624,66.56574394
E02000009,Barking and Dagenham 008,1578,1600,811,252,13,4254,62.90550071
E02000010,Barking and Dagenham 009,1219,1241,634,211,22,3327,63.36038473
E02000011,Barking and Dagenham 010,904,912,433,90,13,2352,61.56462585
E02000012,Barking and Dagenham 011,1394,1145,605,134,9,3287,57.59050806
E02000013,Barking and Dagenham 012,1103,1216,695,225,15,3254,66.10325753
E02000014,Barking and Dagenham 013,1177,1262,692,245,12,3388,65.25974026
E02000015,Barking and Dagenham 014,1041,1145,632,202,13,3033,65.67754698
E02000016,Barking and Dagenham 015,1433,1449,694,214,21,3811,62.39832065
E02000017,Barking and Dagenham 016,1018,1086,473,180,8,2765,63.18264014
E02000018,Barking and Dagenham 017,1086,1234,673,231,10,3234,66.41929499
E02000019,Barking and Dagenham 018,1202,1178,633,187,4,3204,62.48439451
E02000020,Barking and Dagenham 019,1946,1710,792,217,7,4672,58.34760274
E02000021,Barking and Dagenham 020,1098,1155,530,138,8,2929,62.512803
E02000022,Barking and Dagenham 021,1146,1020,463,153,12,2794,58.98353615
E02000023,Barking and Dagenham 022,961,983,520,175,23,2662,63.89932382
E02000024,Barnet 001,2505,1458,430,80,4,4477,44.04735314
E02000025,Barnet 002,1800,1231,538,156,22,3747,51.96156926
E02000026,Barnet 003,1392,744,316,51,7,2510,44.54183267
E02000027,Barnet 004,1712,1176,601,183,13,3685,53.54138399
E02000028,Barnet 005,1477,841,309,57,8,2692,45.13372957
E02000029,Barnet 006,1852,1186,502,154,13,3707,50.04046399
E02000030,Barnet 007,2006,1037,379,90,7,3519,42.99516908
E02000031,Barnet 008,1960,972,322,69,4,3327,41.08806733
E02000032,Barnet 009,1499,928,272,44,1,2744,45.37172012
E02000033,Barnet 010,1744,1126,498,117,7,3492,50.05727377
E02000034,Barnet 011,1863,1184,417,115,9,3588,48.07692308
E02000035,Barnet 012,1859,1126,415,114,15,3529,47.32218759
E02000036,Barnet 013,1900,1364,525,148,7,3944,51.82555781
E02000037,Barnet 014,1970,1186,474,81,6,3717,47.00026903
E02000038,Barnet 015,2078,1279,521,117,10,4005,48.11485643
E02000039,Barnet 016,1500,856,235,79,6,2676,43.94618834
E02000040,Barnet 017,1944,1011,443,106,7,3511,44.63115921
E02000041,Barnet 018,1510,1160,522,113,21,3326,54.60012026
E02000042,Barnet 019,2146,1619,697,209,46,4717,54.50498198
E02000043,Barnet 020,1674,754,200,35,4,2667,37.23284589
E02000044,Barnet 021,1222,1123,540,170,15,3070,60.19543974
E02000045,Barnet 022,1952,1381,661,192,15,4201,53.53487265
E02000046,Barnet 023,1513,960,319,77,10,2879,47.44703022
E02000047,Barnet 024,1418,1685,828,266,13,4210,66.31828979
E02000048,Barnet 025,2186,1215,441,95,12,3949,44.64421372
E02000049,Barnet 026,1445,1341,713,271,32,3802,61.99368753
E02000050,Barnet 027,1861,1371,613,179,10,4034,53.8671294
E02000051,Barnet 028,1931,1229,473,132,28,3793,49.09042974
E02000052,Barnet 029,2200,1409,457,117,8,4191,47.50656168
E02000054,Barnet 031,1400,986,457,108,20,2971,52.87781892
E02000055,Barnet 032,1893,1713,692,189,21,4508,58.0079858
E02000056,Barnet 033,2212,936,252,36,6,3442,35.73503777
E02000057,Barnet 034,1298,885,384,111,28,2706,52.03252033
E02000058,Barnet 035,2216,1287,454,125,16,4098,45.92484139
E02000059,Barnet 036,1855,1608,747,207,20,4437,58.19247239
E02000060,Barnet 037,1694,1246,545,165,45,3695,54.15426252
E02000061,Barnet 038,1891,1154,376,110,43,3574,47.09009513
E02000062,Barnet 039,939,972,496,189,20,2616,64.10550459
E02000063,Barnet 040,1237,1010,423,134,29,2833,56.33603953
E02000064,Barnet 041,1323,908,393,121,17,2762,52.09992759
E02000065,Bexley 001,1143,1039,452,132,9,2775,58.81081081
E02000066,Bexley 002,1301,1338,661,228,20,3548,63.33145434
E02000067,Bexley 003,1793,1388,617,167,18,3983,54.98368064
E02000068,Bexley 004,1331,1095,606,149,15,3196,58.35419274
E02000069,Bexley 005,1298,1043,365,96,8,2810,53.80782918
E02000070,Bexley 006,1433,1114,489,97,7,3140,54.36305732
E02000071,Bexley 007,1288,1044,415,82,5,2834,54.55187015
E02000072,Bexley 008,1957,1550,858,299,21,4685,58.22838847
E02000073,Bexley 009,2122,1327,428,74,6,3957,46.37351529
E02000074,Bexley 010,1373,1258,671,186,15,3503,60.80502426
E02000075,Bexley 011,1597,1114,382,52,4,3149,49.28548746
E02000077,Bexley 013,1421,981,435,96,3,2936,51.60081744
E02000078,Bexley 014,1607,992,357,58,5,3019,46.77045379
E02000079,Bexley 015,1858,1211,433,79,7,3588,48.21627648
E02000080,Bexley 016,1890,1334,504,84,3,3815,50.4587156
E02000081,Bexley 017,1589,1121,461,105,3,3279,51.54010369
E02000082,Bexley 018,1920,1087,379,54,3,3443,44.23467906
E02000083,Bexley 019,2166,1462,654,148,14,4444,51.26012601
E02000084,Bexley 020,2297,1390,445,64,3,4199,45.29649917
E02000085,Bexley 021,1553,1064,386,69,1,3073,49.46306541
E02000086,Bexley 022,1542,905,289,50,2,2788,44.69153515
E02000087,Bexley 023,1842,1091,335,48,2,3318,44.48462929
E02000088,Bexley 024,1644,938,342,52,4,2980,44.83221477
E02000089,Bexley 025,1598,973,276,53,4,2904,44.97245179
E02000090,Bexley 026,2229,1385,475,99,6,4194,46.85264664
E02000091,Bexley 027,2165,1521,631,126,7,4450,51.34831461
E02000092,Bexley 028,1122,935,477,170,10,2714,58.65880619
E02000093,Brent 001,1696,1398,541,101,4,3740,54.65240642
E02000094,Brent 002,1561,1220,546,138,2,3467,54.97548313
E02000095,Brent 003,1338,1220,505,119,3,3185,57.99058085
E02000096,Brent 004,1262,899,298,38,2,2499,49.49979992
E02000097,Brent 005,1242,1134,527,132,3,3038,59.11784068
E02000098,Brent 006,1178,1104,445,139,9,2875,59.02608696
E02000099,Brent 007,1243,1068,467,138,3,2919,57.4169236
E02000100,Brent 008,1299,898,319,51,0,2567,49.39618231
E02000101,Brent 009,1278,1250,669,177,12,3386,62.25634968
E02000102,Brent 010,775,1079,609,199,24,2686,71.14668652
E02000103,Brent 011,1276,1323,626,214,23,3462,63.14269209
E02000104,Brent 012,969,864,415,145,23,2416,59.89238411
E02000105,Brent 013,1165,1241,552,140,9,3107,62.50402317
E02000106,Brent 014,1153,1385,800,227,20,3585,67.83821478
E02000107,Brent 015,1698,1558,798,272,36,4362,61.07290234
E02000108,Brent 016,919,869,387,92,8,2275,59.6043956
E02000110,Brent 018,1324,1077,540,143,11,3095,57.22132472
E02000111,Brent 019,1069,1264,674,165,17,3189,66.47851991
E02000112,Brent 020,1256,1389,715,130,5,3495,64.06294707
E02000113,Brent 021,813,1277,820,345,34,3289,75.2812405
E02000114,Brent 022,1518,1289,644,235,21,3707,59.0504451
E02000115,Brent 023,1710,1261,658,199,51,3879,55.91647332
E02000116,Brent 024,1059,1200,710,249,19,3237,67.28452271
E02000117,Brent 025,1423,1764,1088,428,54,4757,70.08618877
E02000118,Brent 026,1058,1249,662,173,15,3157,66.48717137
E02000119,Brent 027,1405,1476,778,277,16,3952,64.44838057
E02000120,Brent 028,1993,1390,613,220,24,4240,52.99528302
E02000121,Brent 029,1287,1488,659,176,17,3627,64.51612903
E02000122,Brent 030,1603,993,410,144,10,3160,49.2721519
E02000123,Brent 031,1783,2139,1185,371,61,5539,67.81007402
E02000124,Brent 032,2247,1266,494,141,14,4162,46.01153292
E02000125,Brent 033,1909,1269,551,199,14,3942,51.57280568
E02000126,Brent 034,1288,1257,617,229,17,3408,62.20657277
E02000127,Bromley 001,1628,1257,669,221,9,3784,56.97674419
E02000128,Bromley 002,1717,925,362,57,2,3063,43.9438459
E02000130,Bromley 004,2010,1120,417,110,9,3666,45.17184943
E02000131,Bromley 005,2761,1508,583,199,17,5068,45.52091555
E02000132,Bromley 006,2833,1508,484,109,8,4942,42.67503035
E02000133,Bromley 007,2841,1164,274,46,4,4329,34.37283437
E02000134,Bromley 008,2904,1611,615,159,11,5300,45.20754717
E02000135,Bromley 009,1808,1513,768,331,23,4443,59.3067747
E02000136,Bromley 010,1098,743,357,83,13,2294,52.13600697
E02000137,Bromley 011,2246,1076,291,59,2,3674,38.86771911
E02000138,Bromley 012,2501,1252,341,43,2,4139,39.57477652
E02000139,Bromley 013,1947,925,344,85,7,3308,41.1426844
E02000140,Bromley 014,1253,1115,708,246,17,3339,62.47379455
E02000141,Bromley 015,1646,983,378,77,9,3093,46.78305852
E02000142,Bromley 016,2087,1027,297,40,1,3452,39.54229432
E02000144,Bromley 018,2643,1257,349,59,1,4309,38.66326294
E02000145,Bromley 019,1425,1221,610,245,13,3514,59.4479226
E02000146,Bromley 020,2346,1168,391,124,8,4037,41.88754025
E02000147,Bromley 021,1997,902,226,38,4,3167,36.94347963
E02000148,Bromley 022,1565,841,236,54,3,2699,42.01556132
E02000149,Bromley 023,1598,1053,490,130,13,3284,51.33982948
E02000150,Bromley 024,1806,958,298,49,3,3114,42.00385356
E02000151,Bromley 025,1821,907,210,32,0,2970,38.68686869
E02000152,Bromley 026,1530,930,502,128,6,3096,50.58139535
E02000153,Bromley 027,1781,848,238,24,4,2895,38.48013817
E02000154,Bromley 028,1999,1127,366,76,6,3574,44.06827084
E02000155,Bromley 029,1425,1067,455,87,6,3040,53.125
E02000156,Bromley 030,2723,1577,490,65,7,4862,43.99424105
E02000157,Bromley 031,1911,1068,284,14,2,3279,41.7200366
E02000158,Bromley 032,1499,1023,420,91,3,3036,50.62582345
E02000159,Bromley 033,1643,877,262,39,1,2822,41.77888023
E02000160,Bromley 034,1714,979,314,36,1,3044,43.69250986
E02000161,Bromley 035,1980,1033,295,36,1,3345,40.80717489
E02000162,Bromley 036,1461,1019,384,94,5,2963,50.69186635
E02000163,Bromley 037,1731,983,310,43,1,3068,43.57887875
E02000165,Bromley 039,1504,907,291,38,1,2741,45.12951478
E02000166,Camden 001,1669,1069,476,164,17,3395,50.83946981
E02000167,Camden 002,2167,940,201,58,7,3373,35.7545212
E02000168,Camden 003,1859,1035,439,150,11,3494,46.79450487
E02000169,Camden 004,1946,804,209,58,9,3026,35.69068077
E02000170,Camden 005,1886,1032,386,132,29,3465,45.56998557
E02000171,Camden 006,1766,1045,389,122,8,3330,46.96696697
E02000172,Camden 007,1491,1285,833,381,45,4035,63.04832714
E02000173,Camden 008,1977,1114,304,85,21,3501,43.53041988
E02000174,Camden 009,1565,1121,580,260,25,3551,55.92790763
E02000175,Camden 010,2293,1265,528,198,24,4308,46.77344475
E02000176,Camden 011,1748,899,258,80,15,3000,41.73333333
E02000177,Camden 012,1529,1208,642,257,18,3654,58.15544609
E02000178,Camden 013,1792,1314,700,312,48,4166,56.98511762
E02000179,Camden 014,1290,806,306,131,14,2547,49.35217903
E02000180,Camden 015,1616,1139,552,190,20,3517,54.05174865
E02000181,Camden 016,2216,1063,357,104,11,3751,40.92242069
E02000182,Camden 017,1630,959,391,93,9,3082,47.11226476
E02000183,Camden 018,1868,1077,479,176,16,3616,48.34070796
E02000184,Camden 019,1480,1181,661,278,34,3634,59.27352779
E02000185,Camden 020,1366,1465,854,319,66,4070,66.43734644
E02000186,Camden 021,1380,945,473,128,15,2941,53.07718463
E02000187,Camden 022,1228,1390,818,337,44,3817,67.82813728
E02000188,Camden 023,892,978,590,235,24,2719,67.19382126
E02000191,Camden 026,1029,730,268,66,13,2106,51.13960114
E02000192,Camden 027,1315,997,565,191,24,3092,57.47089263
E02000193,Camden 028,1398,1132,439,120,12,3101,54.91776846
E02000194,Croydon 001,2212,1324,511,139,17,4203,47.37092553
E02000195,Croydon 002,1805,1148,446,79,12,3490,48.28080229
E02000196,Croydon 003,1179,1043,468,111,13,2814,58.10234542
E02000197,Croydon 004,1562,1175,473,99,13,3322,52.98013245
E02000198,Croydon 005,1451,1242,612,180,17,3502,58.56653341
E02000199,Croydon 006,1591,1088,415,107,7,3208,50.40523691
E02000200,Croydon 007,1904,1422,513,149,12,4000,52.4
E02000201,Croydon 008,1562,1341,670,210,38,3821,59.12064904
E02000202,Croydon 009,1395,1064,455,109,12,3035,54.03624382
E02000203,Croydon 010,1246,1142,569,144,18,3119,60.05129849
E02000204,Croydon 011,1331,1229,525,125,17,3227,58.75426092
E02000206,Croydon 013,1825,1641,742,234,27,4469,59.16312374
E02000207,Croydon 014,1568,1197,557,218,20,3560,55.95505618
E02000208,Croydon 015,1462,1527,788,280,41,4098,64.32406052
E02000209,Croydon 016,1393,1049,498,119,3,3062,54.50685826
E02000210,Croydon 017,1769,1135,433,92,15,3444,48.63530778
E02000211,Croydon 018,1786,1107,336,62,3,3294,45.78020644
E02000212,Croydon 019,1234,1209,624,174,22,3263,62.18204107
E02000213,Croydon 020,2130,1954,977,288,42,5391,60.48970506
E02000214,Croydon 021,1242,778,254,46,5,2325,46.58064516
E02000215,Croydon 022,2394,1800,817,222,22,5255,54.44338725
E02000216,Croydon 023,1623,915,326,70,8,2942,44.83344663
E02000217,Croydon 024,2309,1740,744,209,17,5019,53.99481969
E02000218,Croydon 025,1069,789,380,104,7,2349,54.49127288
E02000219,Croydon 026,1620,1042,278,41,2,2983,45.69225612
E02000221,Croydon 028,1701,1356,700,220,11,3988,57.34704112
E02000222,Croydon 029,2032,1127,393,73,10,3635,44.09903714
E02000223,Croydon 030,875,1012,669,222,11,2789,68.62674794
E02000224,Croydon 031,1780,1014,385,79,13,3271,45.58239071
E02000225,Croydon 032,951,954,571,171,11,2658,64.22121896
E02000226,Croydon 033,1588,910,247,35,1,2781,42.89823804
E02000227,Croydon 034,2387,1686,627,129,11,4840,50.68181818
E02000228,Croydon 035,1863,885,235,20,4,3007,38.04456269
E02000229,Croydon 036,672,826,531,197,11,2237,69.95976755
E02000230,Croydon 037,2414,1249,479,82,8,4232,42.9584121
E02000231,Croydon 038,1698,839,180,32,3,2752,38.2994186
E02000232,Croydon 039,1219,807,287,50,4,2367,48.50021124
E02000233,Croydon 040,1390,673,277,53,3,2396,41.98664441
E02000234,Croydon 041,2018,1154,450,93,4,3719,45.73810164
E02000235,Croydon 042,1600,799,210,47,1,2657,39.78170869
E02000236,Croydon 043,2026,982,255,44,1,3308,38.75453446
E02000237,Croydon 044,1633,985,337,76,3,3034,46.17666447
E02000238,Ealing 001,1692,1362,571,100,11,3736,54.71092077
E02000239,Ealing 002,1471,1036,360,60,6,2933,49.84657347
E02000240,Ealing 003,1524,1436,711,209,17,3897,60.89299461
E02000241,Ealing 004,1168,959,374,90,6,2597,55.02502888
E02000242,Ealing 005,958,850,362,60,1,2231,57.05961452
E02000243,Ealing 006,1343,1154,502,120,11,3130,57.09265176
E02000244,Ealing 007,1352,1045,416,102,22,2937,53.96663262
E02000245,Ealing 008,1152,1222,718,242,19,3353,65.64270802
E02000246,Ealing 009,1131,1143,608,173,16,3071,63.17160534
E02000247,Ealing 010,1511,1423,720,221,17,3892,61.17677287
E02000248,Ealing 011,1394,1074,407,106,8,2989,53.36232854
E02000249,Ealing 012,1141,1153,495,118,6,2913,60.83075867
E02000250,Ealing 013,1573,749,188,31,3,2544,38.16823899
E02000251,Ealing 014,1074,969,410,85,4,2542,57.7498033
E02000252,Ealing 015,1869,1607,693,218,21,4408,57.59981851
E02000253,Ealing 016,1438,1386,766,225,24,3839,62.54232873
E02000254,Ealing 017,922,966,556,155,9,2608,64.64723926
E02000255,Ealing 018,1940,1212,486,138,16,3792,48.83966245
E02000256,Ealing 019,2293,1225,390,99,19,4026,43.04520616
E02000258,Ealing 021,1258,883,338,100,23,2602,51.65257494
E02000259,Ealing 022,1244,821,269,60,1,2395,48.05845511
E02000260,Ealing 023,797,1101,641,206,9,2754,71.06027596
E02000261,Ealing 024,2324,1728,723,181,24,4980,53.33333333
E02000262,Ealing 025,1820,1313,599,193,21,3946,53.87734415
E02000263,Ealing 026,968,1446,934,280,18,3646,73.45035656
E02000264,Ealing 027,1877,1167,390,92,17,3543,47.02229749
E02000265,Ealing 028,2198,1491,749,266,31,4735,53.57972545
E02000266,Ealing 029,1581,1475,891,338,10,4295,63.18975553
E02000267,Ealing 030,1682,999,426,105,9,3221,47.78019249
E02000268,Ealing 031,2134,1154,441,126,8,3863,44.75796013
E02000269,Ealing 032,1993,956,270,65,21,3305,39.69742814
E02000270,Ealing 033,2035,1272,591,197,19,4114,50.53475936
E02000271,Ealing 034,1997,714,211,47,9,2978,32.94157152
E02000272,Ealing 035,1446,801,230,61,2,2540,43.07086614
E02000275,Ealing 038,712,895,553,173,15,2348,69.67632027
E02000276,Ealing 039,1593,782,275,71,3,2724,41.51982379
E02000277,Enfield 001,975,989,510,143,10,2627,62.88542063
E02000278,Enfield 002,1101,1237,768,211,22,3339,67.02605571
E02000279,Enfield 003,1665,1581,841,300,29,4416,62.29619565
E02000280,Enfield 004,1596,1163,488,147,16,3410,53.19648094
E02000281,Enfield 005,1460,1216,643,210,20,3549,58.86165117
E02000282,Enfield 006,1036,1363,745,280,42,3466,70.10963647
E02000283,Enfield 007,1057,1027,540,167,9,2800,62.25
E02000284,Enfield 008,1858,1148,466,138,7,3617,48.63146254
E02000285,Enfield 009,1380,757,268,53,4,2462,43.94800975
E02000286,Enfield 010,2099,1317,464,108,13,4001,47.53811547
E02000287,Enfield 011,1587,889,316,64,11,2867,44.6459714
E02000288,Enfield 012,1320,1510,891,299,33,4053,67.4315322
E02000289,Enfield 013,1381,756,251,35,3,2426,43.07502061
E02000290,Enfield 014,826,944,551,182,20,2523,67.26119699
E02000291,Enfield 015,1919,1580,641,166,19,4325,55.6300578
E02000292,Enfield 016,1731,1196,509,126,7,3569,51.49901933
E02000293,Enfield 017,1428,795,231,34,3,2491,42.67362505
E02000294,Enfield 018,1094,1204,607,167,12,3084,64.52658885
E02000295,Enfield 019,1757,1103,361,121,8,3350,47.55223881
E02000296,Enfield 020,1891,1416,604,127,1,4039,53.18148056
E02000297,Enfield 021,1765,1208,432,66,4,3475,49.20863309
E02000298,Enfield 022,1780,967,265,40,4,3056,41.7539267
E02000299,Enfield 023,1139,1230,709,208,28,3314,65.63065782
E02000300,Enfield 024,1020,1145,621,179,34,2999,65.98866289
E02000301,Enfield 025,1127,1441,840,292,25,3725,69.74496644
E02000302,Enfield 026,1416,1124,455,112,7,3114,54.52793834
E02000303,Enfield 027,870,1156,641,274,35,2976,70.76612903
E02000304,Enfield 028,1678,921,279,30,2,2910,42.33676976
E02000305,Enfield 029,1778,1129,450,90,5,3452,48.49362688
E02000306,Enfield 030,854,1327,832,373,16,3402,74.89711934
E02000307,Enfield 031,1371,1262,578,125,8,3344,59.00119617
E02000308,Enfield 032,1477,1117,496,125,11,3226,54.21574706
E02000309,Enfield 033,1281,1599,809,272,26,3987,67.87057938
E02000311,Enfield 035,1389,1351,662,222,11,3635,61.78817056
E02000312,Enfield 036,1982,1656,647,184,26,4495,55.90656285
E02000313,Greenwich 001,879,1012,513,165,26,2595,66.12716763
E02000314,Greenwich 002,1991,1596,683,254,12,4536,56.10670194
E02000315,Greenwich 003,1227,1288,693,248,34,3490,64.84240688
E02000317,Greenwich 005,1067,1006,532,203,16,2824,62.21671388
E02000318,Greenwich 006,1282,1314,718,248,19,3581,64.19994415
E02000319,Greenwich 007,1636,1360,661,232,30,3919,58.2546568
E02000320,Greenwich 008,1142,891,395,117,12,2557,55.33828706
E02000321,Greenwich 009,1014,1106,590,222,26,2958,65.72008114
E02000323,Greenwich 011,2062,1699,763,266,30,4820,57.21991701
E02000324,Greenwich 012,1108,1003,516,215,13,2855,61.19089317
E02000326,Greenwich 014,1680,891,365,102,11,3049,44.8999672
E02000327,Greenwich 015,1112,850,498,158,15,2633,57.76680592
E02000328,Greenwich 016,1658,822,356,107,3,2946,43.72029871
E02000329,Greenwich 017,1040,871,399,140,12,2462,57.75792039
E02000331,Greenwich 019,1429,993,558,195,16,3191,55.21780006
E02000332,Greenwich 020,1555,995,369,77,5,3001,48.18393869
E02000333,Greenwich 021,1727,797,282,69,8,2883,40.09712105
E02000334,Greenwich 022,1180,852,374,127,9,2542,53.57985838
E02000335,Greenwich 023,1362,844,316,70,0,2592,47.4537037
E02000337,Greenwich 025,1201,1069,593,211,9,3083,61.04443724
E02000339,Greenwich 027,1304,862,346,73,7,2592,49.69135802
E02000340,Greenwich 028,1513,998,422,83,4,3020,49.90066225
E02000341,Greenwich 029,1064,1017,608,242,9,2940,63.80952381
E02000342,Greenwich 030,1106,724,379,124,9,2342,52.77540564
E02000343,Greenwich 031,1191,869,478,143,12,2693,55.77422948
E02000344,Greenwich 032,1338,748,298,63,1,2448,45.34313725
E02000345,Hackney 001,927,1007,476,144,34,2588,64.18083462
E02000346,Hackney 002,1800,1240,670,246,16,3972,54.68277946
E02000347,Hackney 003,984,1025,423,137,13,2582,61.89000775
E02000348,Hackney 004,892,1009,556,232,36,2725,67.26605505
E02000350,Hackney 006,1665,1281,515,208,24,3693,54.91470349
E02000351,Hackney 007,2066,1394,570,186,17,4233,51.19300732
E02000352,Hackney 008,1306,838,387,144,10,2685,51.3594041
E02000353,Hackney 009,1662,962,368,153,11,3156,47.33840304
E02000354,Hackney 010,1628,1304,754,272,32,3990,59.19799499
E02000355,Hackney 011,1456,991,484,166,16,3113,53.22839704
E02000356,Hackney 012,1736,865,336,104,20,3061,43.28650768
E02000357,Hackney 013,930,994,582,196,19,2721,65.8213892
E02000358,Hackney 014,2230,1468,837,255,29,4819,53.72483918
E02000359,Hackney 015,1115,749,388,172,14,2438,54.26579163
E02000360,Hackney 016,1931,1601,903,385,31,4851,60.19377448
E02000361,Hackney 017,1668,1189,584,217,20,3678,54.64926591
E02000362,Hackney 018,1155,915,530,190,16,2806,58.83820385
E02000363,Hackney 019,1604,1625,830,358,24,4441,63.88200856
E02000364,Hackney 020,2031,1237,593,221,17,4099,50.45132959
E02000366,Hackney 022,1404,1162,645,304,24,3539,60.32777621
E02000367,Hackney 023,2390,1363,621,206,15,4595,47.98694233
E02000368,Hackney 024,1633,1336,835,317,31,4152,60.66955684
E02000369,Hackney 025,2878,1856,867,309,19,5929,51.45893068
E02000370,Hackney 026,1854,1278,586,247,26,3991,53.54547732
E02000372,Hammersmith and Fulham 001,1481,1400,720,254,21,3876,61.79050568
E02000373,Hammersmith and Fulham 002,860,928,551,176,20,2535,66.07495069
E02000374,Hammersmith and Fulham 003,1183,838,442,144,10,2617,54.79556744
E02000375,Hammersmith and Fulham 004,1500,1218,570,181,28,3497,57.10609094
E02000376,Hammersmith and Fulham 005,1432,1081,481,163,24,3181,54.98270984
E02000377,Hammersmith and Fulham 006,1593,1093,546,181,31,3444,53.7456446
E02000378,Hammersmith and Fulham 007,1593,1087,427,137,7,3251,50.9996924
E02000379,Hammersmith and Fulham 008,1702,926,349,113,13,3103,45.14985498
E02000380,Hammersmith and Fulham 009,1384,766,263,77,11,2501,44.66213515
E02000381,Hammersmith and Fulham 010,1863,1106,412,144,23,3548,47.49154453
E02000382,Hammersmith and Fulham 011,1519,825,293,117,18,2772,45.2020202
E02000383,Hammersmith and Fulham 012,2087,1346,524,135,19,4111,49.23376307
E02000384,Hammersmith and Fulham 013,1802,1201,572,209,21,3805,52.6412615
E02000385,Hammersmith and Fulham 014,1638,849,270,78,13,2848,42.48595506
E02000386,Hammersmith and Fulham 015,1360,1196,611,188,11,3366,59.5959596
E02000387,Hammersmith and Fulham 016,1194,861,398,121,11,2585,53.81044487
E02000388,Hammersmith and Fulham 017,2297,1204,471,149,13,4134,44.43638123
E02000389,Hammersmith and Fulham 018,2147,1104,342,80,6,3679,41.64175048
E02000390,Hammersmith and Fulham 019,1482,786,322,113,16,2719,45.49466716
E02000391,Hammersmith and Fulham 020,1959,875,334,105,8,3281,40.29259372
E02000392,Hammersmith and Fulham 021,2341,1108,438,137,15,4039,42.04010894
E02000393,Hammersmith and Fulham 022,1715,633,185,47,8,2588,33.73261206
E02000394,Hammersmith and Fulham 023,2385,1304,510,133,14,4346,45.12195122
E02000395,Hammersmith and Fulham 024,1679,723,194,42,5,2643,36.47370412
E02000396,Hammersmith and Fulham 025,1553,783,329,91,14,2770,43.93501805
E02000397,Haringey 001,1335,1210,657,235,35,3472,61.54953917
E02000398,Haringey 002,797,1047,715,280,42,2881,72.33599445
E02000400,Haringey 004,1370,1054,535,149,12,3120,56.08974359
E02000401,Haringey 005,823,832,577,228,17,2477,66.77432378
E02000402,Haringey 006,774,868,556,214,13,2425,68.08247423
E02000403,Haringey 007,1162,1101,531,175,21,2990,61.13712375
E02000404,Haringey 008,924,971,548,214,8,2665,65.32833021
E02000405,Haringey 009,1475,726,206,52,5,2464,40.13798701
E02000406,Haringey 010,1022,845,542,170,16,2595,60.61657033
E02000407,Haringey 011,995,1078,657,240,35,3005,66.88851913
E02000408,Haringey 012,982,1071,707,220,21,3001,67.27757414
E02000409,Haringey 013,810,864,495,183,18,2370,65.82278481
E02000410,Haringey 014,1561,813,200,32,8,2614,40.28309105
E02000411,Haringey 015,1606,1420,666,237,24,3953,59.37262838
E02000412,Haringey 016,989,1051,598,201,30,2869,65.52805856
E02000413,Haringey 017,1672,904,313,70,4,2963,43.57070537
E02000414,Haringey 018,1097,992,476,136,17,2718,59.63944077
E02000415,Haringey 019,1139,1014,506,154,22,2835,59.82363316
E02000416,Haringey 020,1929,1208,576,192,14,3919,50.77825976
E02000417,Haringey 021,1684,871,247,63,2,2867,41.26264388
E02000418,Haringey 022,1306,637,215,47,3,2208,40.85144928
E02000419,Haringey 023,1506,1262,622,210,45,3645,58.68312757
E02000420,Haringey 024,1303,1215,683,213,22,3436,62.07799767
E02000421,Haringey 025,1049,1146,696,232,17,3140,66.59235669
E02000422,Haringey 026,1006,1096,580,185,20,2887,65.15413924
E02000423,Haringey 027,1155,895,443,166,13,2672,56.7739521
E02000424,Haringey 028,1598,889,372,118,7,2984,46.44772118
E02000425,Haringey 029,742,880,404,117,20,2163,65.69579288
E02000426,Haringey 030,1612,765,276,86,3,2742,41.21079504
E02000427,Haringey 031,1313,979,435,122,18,2867,54.20299965
E02000428,Haringey 032,933,1098,662,217,12,2922,68.0698152
E02000429,Haringey 033,1899,958,269,69,6,3201,40.67478913
E02000430,Haringey 034,1864,973,306,94,10,3247,42.59316292
E02000431,Haringey 035,1760,786,235,56,8,2845,38.1370826
E02000432,Haringey 036,1428,862,363,134,12,2799,48.98177921
E02000433,Harrow 001,1797,1154,462,119,12,3544,49.29458239
E02000434,Harrow 002,1918,1148,444,114,14,3638,47.27872457
E02000435,Harrow 003,1261,955,471,120,5,2812,55.15647226
E02000436,Harrow 004,1225,622,167,29,1,2044,40.06849315
E02000437,Harrow 005,1385,1147,448,102,7,3089,55.16348333
E02000438,Harrow 006,1380,1074,479,103,7,3043,54.65001643
E02000439,Harrow 007,1273,1103,440,122,10,2948,56.81818182
E02000440,Harrow 008,1690,994,316,46,6,3052,44.62647444
E02000441,Harrow 009,1431,899,372,89,2,2793,48.76476907
E02000442,Harrow 010,1086,1059,436,81,5,2667,59.28008999
E02000443,Harrow 011,1457,1296,604,165,24,3546,58.91144952
E02000444,Harrow 012,1282,968,358,60,4,2672,52.02095808
E02000445,Harrow 013,1558,1397,680,168,17,3820,59.21465969
E02000447,Harrow 015,1479,908,292,61,5,2745,46.12021858
E02000448,Harrow 016,1591,846,251,58,13,2759,42.33417905
E02000449,Harrow 017,1032,969,412,108,5,2526,59.14489311
E02000451,Harrow 019,1369,740,196,22,2,2329,41.21940747
E02000452,Harrow 020,1585,1215,516,126,7,3449,54.04465062
E02000453,Harrow 021,1520,1056,369,90,12,3047,50.11486708
E02000454,Harrow 022,1586,720,195,21,0,2522,37.11340206
E02000455,Harrow 023,2460,1531,613,138,17,4759,48.30846817
E02000456,Harrow 024,1240,958,405,107,7,2717,54.36142805
E02000457,Harrow 025,1317,891,288,61,6,2563,48.61490441
E02000459,Harrow 027,1439,1283,528,160,8,3418,57.89935635
E02000460,Harrow 028,1114,814,364,115,8,2415,53.87163561
E02000461,Harrow 029,1438,796,261,56,8,2559,43.80617429
E02000462,Harrow 030,982,869,350,77,8,2286,57.04286964
E02000463,Harrow 031,1262,1017,435,114,6,2834,55.46930134
E02000464,Havering 001,1111,1021,547,176,20,2875,61.35652174
E02000465,Havering 002,1389,1169,682,237,15,3492,60.2233677
E02000466,Havering 003,1397,1186,547,155,9,3294,57.58955677
E02000467,Havering 004,1358,1607,948,344,33,4290,68.34498834
E02000468,Havering 005,1431,1149,480,98,7,3165,54.78672986
E02000469,Havering 006,1032,981,526,148,12,2699,61.76361615
E02000470,Havering 007,2179,1376,469,98,9,4131,47.25248124
E02000471,Havering 008,1479,1053,355,54,0,2941,49.71098266
E02000472,Havering 009,1688,1232,510,95,3,3528,52.15419501
E02000473,Havering 010,2137,1315,484,82,7,4025,46.9068323
E02000474,Havering 011,1582,1259,561,121,8,3531,55.19682809
E02000475,Havering 012,2157,1249,457,94,1,3958,45.50277918
E02000476,Havering 013,1956,1369,693,170,11,4199,53.41748035
E02000477,Havering 014,2003,1226,420,63,4,3716,46.09795479
E02000478,Havering 015,1133,715,269,32,1,2150,47.30232558
E02000479,Havering 016,1873,1193,559,153,11,3789,50.56743204
E02000480,Havering 017,2350,1703,754,195,10,5012,53.11252993
E02000481,Havering 018,1588,1158,432,63,5,3246,51.07825015
E02000482,Havering 019,1488,834,234,21,0,2577,42.25844005
E02000483,Havering 020,1557,1292,534,81,9,3473,55.16844227
E02000484,Havering 021,1650,1107,412,83,1,3253,49.27758992
E02000485,Havering 022,1819,1172,417,47,0,3455,47.35166425
E02000486,Havering 023,1420,1064,425,76,5,2990,52.5083612
E02000487,Havering 024,1720,943,248,31,2,2944,41.57608696
E02000488,Havering 025,1607,1008,353,45,1,3014,46.68214997
E02000489,Havering 026,1509,1147,501,98,6,3261,53.72585097
E02000490,Havering 027,1397,1187,531,107,4,3226,56.69559826
E02000491,Havering 028,1685,1373,672,191,13,3934,57.16827656
E02000492,Havering 029,1192,958,383,87,2,2622,54.53852021
E02000493,Havering 030,1018,922,456,97,4,2497,59.23107729
E02000494,Hillingdon 001,1859,979,291,79,8,3216,42.19527363
E02000495,Hillingdon 002,2225,1434,513,127,7,4306,48.32791454
E02000496,Hillingdon 003,1538,1043,487,102,6,3176,51.5743073
E02000497,Hillingdon 004,1908,1168,492,118,9,3695,48.36265223
E02000498,Hillingdon 005,1362,865,324,84,4,2639,48.38954149
E02000499,Hillingdon 006,1698,973,301,38,4,3014,43.66290644
E02000500,Hillingdon 007,1857,1078,328,39,3,3305,43.81240545
E02000501,Hillingdon 008,1836,1062,315,57,3,3273,43.90467461
E02000502,Hillingdon 009,1993,1124,352,57,2,3528,43.50907029
E02000503,Hillingdon 010,1812,1050,337,53,2,3254,44.31468961
E02000504,Hillingdon 011,1793,855,249,24,0,2921,38.61691202
E02000506,Hillingdon 013,1681,891,268,59,0,2899,42.01448775
E02000507,Hillingdon 014,1402,917,369,83,8,2779,49.55019791
E02000508,Hillingdon 015,2271,1316,573,162,17,4339,47.66075133
E02000509,Hillingdon 016,1458,1222,550,161,11,3402,57.14285714
E02000510,Hillingdon 017,1535,1147,473,103,3,3261,52.92854952
E02000511,Hillingdon 018,1413,1239,493,108,9,3262,56.68301655
E02000512,Hillingdon 019,1209,1107,599,174,15,3104,61.05025773
E02000513,Hillingdon 020,1120,1324,667,195,17,3323,66.2955161
E02000514,Hillingdon 021,1261,1268,530,110,8,3177,60.30846711
E02000515,Hillingdon 022,2157,1954,932,273,29,5345,59.6445276
E02000516,Hillingdon 023,1121,1069,497,123,7,2817,60.20589279
E02000517,Hillingdon 024,1233,1227,649,188,24,3321,62.87262873
E02000518,Hillingdon 025,1259,1295,589,176,9,3328,62.16947115
E02000519,Hillingdon 026,951,1160,703,188,23,3025,68.56198347
E02000520,Hillingdon 027,1679,1631,898,234,13,4455,62.31200898
E02000521,Hillingdon 028,1855,1518,751,217,10,4351,57.36612273
E02000522,Hillingdon 029,1462,1239,592,173,22,3488,58.08486239
E02000523,Hillingdon 030,1418,1468,635,148,11,3680,61.4673913
E02000524,Hillingdon 031,965,1040,480,147,7,2639,63.43311861
E02000525,Hillingdon 032,1041,1347,705,206,21,3320,68.64457831
E02000526,Hounslow 001,2375,945,249,46,3,3618,34.35599779
E02000529,Hounslow 004,1118,1169,582,153,13,3035,63.1630972
E02000530,Hounslow 005,768,958,583,191,17,2517,69.4874851
E02000531,Hounslow 006,2565,1518,622,199,32,4936,48.03484603
E02000532,Hounslow 007,2191,1093,404,116,15,3819,42.62896046
E02000533,Hounslow 008,2193,1020,356,105,15,3689,40.55299539
E02000534,Hounslow 009,1611,994,345,47,2,2999,46.28209403
E02000535,Hounslow 010,1119,1195,556,129,7,3006,62.7744511
E02000536,Hounslow 011,1297,1222,585,132,9,3245,60.03081664
E02000537,Hounslow 012,1500,1182,400,65,11,3158,52.50158328
E02000538,Hounslow 013,1045,1176,618,149,16,3004,65.21304927
E02000539,Hounslow 014,2380,1507,669,163,15,4734,49.72539079
E02000540,Hounslow 015,1942,1604,727,182,31,4486,56.70976371
E02000541,Hounslow 016,1046,1301,702,220,9,3278,68.09029896
E02000542,Hounslow 017,1229,1648,810,243,23,3953,68.90968884
E02000543,Hounslow 018,1854,1903,870,236,29,4892,62.10139002
E02000544,Hounslow 019,1482,978,383,75,4,2922,49.28131417
E02000545,Hounslow 020,1597,1143,628,169,11,3548,54.98872604
E02000546,Hounslow 021,1169,1230,603,150,7,3159,62.99461855
E02000547,Hounslow 022,1420,1494,745,181,14,3854,63.15516347
E02000548,Hounslow 023,1348,1457,688,213,20,3726,63.82179281
E02000549,Hounslow 024,1637,1557,708,165,16,4083,59.90693118
E02000550,Hounslow 025,1492,1354,663,196,14,3719,59.88168863
E02000551,Hounslow 026,1179,1279,742,190,25,3415,65.47584187
E02000552,Hounslow 027,1503,1228,494,127,9,3361,55.28116632
E02000553,Hounslow 028,1116,910,442,117,15,2600,57.07692308
E02000554,Islington 001,1668,1413,786,306,29,4202,60.30461685
E02000555,Islington 002,1885,1306,621,204,18,4034,53.27218642
E02000556,Islington 003,2390,1477,726,320,35,4948,51.69765562
E02000557,Islington 004,1869,1402,618,223,25,4137,54.82233503
E02000558,Islington 005,1336,1400,840,359,22,3957,66.23704827
E02000559,Islington 006,2305,1079,451,149,11,3995,42.3028786
E02000560,Islington 007,1559,1067,505,133,11,3275,52.39694656
E02000561,Islington 008,1713,956,351,123,15,3158,45.75680811
E02000562,Islington 009,1775,1034,505,160,13,3487,49.09664468
E02000563,Islington 010,1487,1304,765,275,27,3858,61.45671332
E02000564,Islington 011,2878,1754,766,239,27,5664,49.18785311
E02000565,Islington 012,1600,1041,599,242,15,3497,54.246497
E02000566,Islington 013,2223,1004,445,156,9,3837,42.06411259
E02000567,Islington 014,2451,1406,728,277,32,4894,49.91826727
E02000568,Islington 015,1911,1533,857,352,16,4669,59.07046477
E02000569,Islington 016,2194,1402,739,250,16,4601,52.31471419
E02000570,Islington 017,2359,1049,424,146,12,3990,40.87719298
E02000571,Islington 018,2068,1185,596,254,19,4122,49.83017952
E02000572,Islington 019,1285,1155,735,331,18,3524,63.53575482
E02000573,Islington 020,2948,1260,512,188,13,4921,40.09347694
E02000574,Islington 021,1839,1104,472,179,11,3605,48.98751734
E02000575,Islington 022,2660,1487,722,278,24,5171,48.55927287
E02000576,Islington 023,2254,1586,814,268,31,4953,54.49222693
E02000577,Kensington and Chelsea 001,1012,1123,693,313,35,3176,68.13602015
E02000578,Kensington and Chelsea 002,705,781,571,229,23,2309,69.46730186
E02000579,Kensington and Chelsea 003,1695,1232,618,240,35,3820,55.62827225
E02000580,Kensington and Chelsea 004,1657,1232,787,263,49,3988,58.45035105
E02000581,Kensington and Chelsea 005,936,1017,653,373,31,3010,68.90365449
E02000582,Kensington and Chelsea 006,1890,994,319,62,8,3273,42.2548121
E02000583,Kensington and Chelsea 007,1898,822,296,83,19,3118,39.12764593
E02000584,Kensington and Chelsea 008,2109,932,231,54,5,3331,36.68567998
E02000585,Kensington and Chelsea 009,1879,1007,361,119,20,3386,44.50679268
E02000586,Kensington and Chelsea 010,1909,781,155,36,0,2881,33.73828532
E02000587,Kensington and Chelsea 011,1967,804,203,50,3,3027,35.01816981
E02000588,Kensington and Chelsea 012,2068,766,192,43,8,3077,32.79168021
E02000589,Kensington and Chelsea 013,1997,1166,371,102,23,3659,45.42224652
E02000590,Kensington and Chelsea 014,1384,1066,417,163,19,3049,54.60806822
E02000591,Kensington and Chelsea 015,1479,1093,447,180,39,3238,54.32365658
E02000592,Kensington and Chelsea 016,1802,811,172,45,9,2839,36.52694611
E02000593,Kensington and Chelsea 017,1990,1188,355,134,17,3684,45.98262758
E02000594,Kensington and Chelsea 018,1825,786,238,60,13,2922,37.54277892
E02000595,Kensington and Chelsea 019,1796,832,263,113,25,3029,40.7065038
E02000596,Kensington and Chelsea 020,1935,819,225,76,18,3073,37.03221608
E02000597,Kensington and Chelsea 021,1242,993,552,184,29,3000,58.6
E02000598,Kingston upon Thames 001,1840,850,236,42,3,2971,38.06799058
E02000599,Kingston upon Thames 002,1485,683,151,30,2,2351,36.8353892
E02000600,Kingston upon Thames 003,1923,1049,339,65,2,3378,43.07282416
E02000601,Kingston upon Thames 004,2987,1327,435,100,9,4858,38.51379168
E02000602,Kingston upon Thames 005,1915,1313,600,204,14,4046,52.66930302
E02000603,Kingston upon Thames 006,1420,952,448,127,3,2950,51.86440678
E02000604,Kingston upon Thames 007,2007,1107,371,70,4,3559,43.60775499
E02000605,Kingston upon Thames 008,1778,932,339,63,3,3115,42.92134831
E02000606,Kingston upon Thames 009,2840,1459,411,89,12,4811,40.96861359
E02000607,Kingston upon Thames 010,1543,755,234,45,6,2583,40.26325978
E02000608,Kingston upon Thames 011,1998,957,360,78,11,3404,41.30434783
E02000609,Kingston upon Thames 012,1373,922,361,77,4,2737,49.83558641
E02000610,Kingston upon Thames 013,2129,1185,431,117,9,3871,45.00129166
E02000611,Kingston upon Thames 014,1565,831,221,31,2,2650,40.94339623
E02000612,Kingston upon Thames 015,1803,944,292,36,3,3078,41.42300195
E02000613,Kingston upon Thames 016,1841,953,313,80,8,3195,42.37871674
E02000614,Kingston upon Thames 017,1750,1092,437,89,6,3374,48.13278008
E02000615,Kingston upon Thames 018,1504,1036,356,57,4,2957,49.1376395
E02000616,Kingston upon Thames 019,1344,776,227,38,0,2385,43.64779874
E02000617,Kingston upon Thames 020,1594,1150,482,114,3,3343,52.318277
E02000619,Lambeth 002,1765,1352,710,211,16,4054,56.46275284
E02000620,Lambeth 003,2288,1453,649,191,8,4589,50.14164306
E02000621,Lambeth 004,3246,1838,697,202,24,6007,45.96304312
E02000622,Lambeth 005,1778,1212,479,146,16,3631,51.03277334
E02000623,Lambeth 006,1288,1239,613,175,13,3328,61.29807692
E02000624,Lambeth 007,2101,1348,611,190,22,4272,50.81928839
E02000625,Lambeth 008,1545,1469,590,172,19,3795,59.28853755
E02000626,Lambeth 009,1236,1287,690,216,19,3448,64.15313225
E02000627,Lambeth 010,1819,1309,605,176,8,3917,53.56139903
E02000628,Lambeth 011,1875,1495,842,248,23,4483,58.17532902
E02000629,Lambeth 012,2386,1064,397,163,6,4016,40.5876494
E02000630,Lambeth 013,2018,966,329,99,18,3430,41.16618076
E02000631,Lambeth 014,1897,1207,476,142,17,3739,49.26450923
E02000632,Lambeth 015,2515,1231,397,110,8,4261,40.97629664
E02000633,Lambeth 016,1826,1292,646,173,26,3963,53.9237951
E02000634,Lambeth 017,1549,921,446,183,8,3107,50.14483425
E02000635,Lambeth 018,2323,1206,602,188,18,4337,46.4376297
E02000636,Lambeth 019,2020,783,231,44,1,3079,34.39428386
E02000637,Lambeth 020,2044,1135,424,95,7,3705,44.83130904
E02000638,Lambeth 021,1980,1362,600,155,10,4107,51.78962747
E02000639,Lambeth 022,1619,1362,559,169,15,3724,56.52524168
E02000640,Lambeth 023,2267,1033,398,95,13,3806,40.43615344
E02000641,Lambeth 024,1346,1182,656,193,13,3390,60.29498525
E02000642,Lambeth 025,2187,1269,536,174,6,4172,47.57909875
E02000643,Lambeth 026,2117,1182,508,134,6,3947,46.36432734
E02000644,Lambeth 027,1913,1102,360,113,8,3496,45.28032037
E02000645,Lambeth 028,2092,1206,559,171,19,4047,48.30738819
E02000646,Lambeth 029,2134,1175,456,127,13,3905,45.35211268
E02000647,Lambeth 030,1775,1100,426,110,12,3423,48.14490213
E02000648,Lambeth 031,1363,1025,606,183,11,3188,57.24592221
E02000649,Lambeth 032,2593,1718,734,228,32,5305,51.12158341
E02000650,Lambeth 033,1576,969,513,207,13,3278,51.9219036
E02000651,Lambeth 034,1711,1166,477,111,14,3479,50.81920092
E02000652,Lambeth 035,1206,907,349,77,3,2542,52.5570417
E02000653,Lewisham 001,2609,1615,796,255,18,5293,50.7084829
E02000654,Lewisham 002,1373,1256,696,245,26,3596,61.81868743
E02000655,Lewisham 003,1615,1481,697,196,18,4007,59.69553282
E02000657,Lewisham 005,1907,1261,589,217,17,3991,52.21748935
E02000658,Lewisham 006,1519,1173,547,203,16,3458,56.07287449
E02000659,Lewisham 007,1916,1064,425,125,11,3541,45.89099125
E02000660,Lewisham 008,1898,1136,440,121,8,3603,47.32167638
E02000661,Lewisham 009,1627,931,354,121,14,3047,46.60321628
E02000662,Lewisham 010,1521,1108,513,153,9,3304,53.96489104
E02000663,Lewisham 011,1475,897,346,95,6,2819,47.67648102
E02000665,Lewisham 013,1764,1044,470,128,10,3416,48.36065574
E02000666,Lewisham 014,1371,876,377,104,8,2736,49.89035088
E02000667,Lewisham 015,1455,713,291,62,3,2524,42.35340729
E02000668,Lewisham 016,1540,780,322,84,1,2727,43.5276861
E02000669,Lewisham 017,1675,1027,442,151,13,3308,49.36517533
E02000670,Lewisham 018,1186,1005,447,132,11,2781,57.35346997
E02000671,Lewisham 019,1979,1074,470,149,9,3681,46.23743548
E02000672,Lewisham 020,1873,1382,599,288,58,4200,55.4047619
E02000673,Lewisham 021,2025,1002,382,89,2,3500,42.14285714
E02000674,Lewisham 022,1519,1042,389,99,8,3057,50.31076219
E02000675,Lewisham 023,1706,1140,446,117,11,3420,50.11695906
E02000676,Lewisham 024,1734,962,396,86,11,3189,45.62558796
E02000677,Lewisham 025,1250,853,424,106,9,2642,52.68735806
E02000678,Lewisham 026,1018,907,493,181,16,2615,61.0707457
E02000679,Lewisham 027,1576,1077,517,183,22,3375,53.3037037
E02000680,Lewisham 028,1388,963,415,131,16,2913,52.35152763
E02000681,Lewisham 029,1363,1146,625,196,20,3350,59.31343284
E02000682,Lewisham 030,1304,1140,580,173,20,3217,59.46534038
E02000683,Lewisham 031,1153,862,522,177,10,2724,57.67254038
E02000685,Lewisham 033,1565,1095,584,155,24,3423,54.27987146
E02000686,Lewisham 034,1168,1057,576,222,21,3044,61.62943495
E02000687,Lewisham 035,1635,1137,508,154,21,3455,52.67727931
E02000689,Merton 001,2322,872,251,58,9,3512,33.88382688
E02000690,Merton 002,1471,594,132,22,6,2225,33.88764045
E02000691,Merton 003,1888,771,258,36,4,2957,36.1515049
E02000692,Merton 004,2340,946,236,44,2,3568,34.41704036
E02000693,Merton 005,2554,1218,404,98,8,4282,40.35497431
E02000694,Merton 006,2347,1020,370,91,6,3834,38.78455921
E02000695,Merton 007,1459,997,407,69,7,2939,50.35726438
E02000696,Merton 008,1529,1185,430,116,9,3269,53.22728663
E02000697,Merton 009,2430,941,255,38,3,3667,33.73329697
E02000698,Merton 010,2101,850,187,44,4,3186,34.05524168
E02000699,Merton 011,2087,902,244,27,2,3262,36.02084611
E02000700,Merton 012,1405,1167,606,168,12,3358,58.15961882
E02000701,Merton 013,1327,1150,520,109,8,3114,57.38599872
E02000702,Merton 014,1417,1226,546,164,13,3366,57.90255496
E02000703,Merton 015,1759,890,247,35,5,2936,40.08855586
E02000704,Merton 016,1997,1074,398,99,5,3573,44.10859222
E02000705,Merton 017,1602,1028,403,76,8,3117,48.60442733
E02000706,Merton 018,1397,1225,672,218,22,3534,60.46972269
E02000707,Merton 019,1087,1048,484,155,4,2778,60.87113031
E02000708,Merton 020,1948,932,319,56,0,3255,40.15360983
E02000709,Merton 021,1600,909,308,51,1,2869,44.23143953
E02000710,Merton 022,1449,1288,566,126,10,3439,57.86565862
E02000711,Merton 023,1599,1200,508,141,10,3458,53.7593985
E02000712,Merton 024,1418,1218,571,186,13,3406,58.36758661
E02000713,Merton 025,1526,944,308,51,1,2830,46.07773852
E02000714,Newham 001,1126,904,459,146,10,2645,57.42911153
E02000715,Newham 002,600,838,463,178,11,2090,71.29186603
E02000716,Newham 003,827,864,450,148,13,2302,64.07471764
E02000717,Newham 004,706,953,538,183,15,2395,70.52192067
E02000718,Newham 005,676,889,486,184,12,2247,69.91544281
E02000719,Newham 006,1149,1043,495,173,11,2871,59.97910136
E02000720,Newham 007,810,772,431,107,3,2123,61.84644371
E02000721,Newham 008,842,1091,630,187,14,2764,69.53690304
E02000722,Newham 009,1134,1056,553,181,11,2935,61.36286201
E02000723,Newham 010,876,1112,641,220,12,2861,69.3813352
E02000724,Newham 011,773,970,602,181,9,2535,69.50690335
E02000725,Newham 012,1689,1384,705,201,22,4001,57.78555361
E02000727,Newham 014,644,943,516,174,13,2290,71.87772926
E02000728,Newham 015,788,910,513,125,6,2342,66.35354398
E02000729,Newham 016,743,834,429,187,9,2202,66.25794732
E02000730,Newham 017,752,992,610,201,11,2566,70.69368667
E02000731,Newham 018,822,1141,592,203,12,2770,70.32490975
E02000732,Newham 019,884,1039,593,215,21,2752,67.87790698
E02000733,Newham 020,1199,1322,671,254,17,3463,65.37684089
E02000734,Newham 021,838,951,521,172,13,2495,66.41282565
E02000735,Newham 022,892,1013,550,177,27,2659,66.45355397
E02000736,Newham 023,848,1044,559,193,10,2654,68.04822909
E02000737,Newham 024,1025,1107,694,222,18,3066,66.56881931
E02000738,Newham 025,1091,1045,495,146,9,2786,60.83991385
E02000739,Newham 026,850,953,502,157,17,2479,65.71198064
E02000740,Newham 027,851,955,509,162,18,2495,65.89178357
E02000741,Newham 028,977,994,531,171,11,2684,63.59910581
E02000742,Newham 029,877,988,497,156,7,2525,65.26732673
E02000743,Newham 030,1318,1244,702,293,21,3578,63.16377865
E02000744,Newham 031,1274,1214,617,203,18,3326,61.69573061
E02000745,Newham 032,1078,1081,537,166,15,2877,62.53041363
E02000746,Newham 033,1596,1081,524,184,11,3396,53.00353357
E02000747,Newham 034,2718,1629,807,274,17,5445,50.08264463
E02000748,Newham 035,857,811,410,122,9,2209,61.20416478
E02000749,Newham 036,1159,1182,683,286,20,3330,65.1951952
E02000751,Redbridge 001,2512,1380,459,82,5,4438,43.39792699
E02000752,Redbridge 002,1410,1087,572,175,22,3266,56.82792407
E02000753,Redbridge 003,1025,864,425,154,6,2474,58.56911884
E02000754,Redbridge 004,1378,792,346,74,2,2592,46.83641975
E02000755,Redbridge 005,1081,750,273,78,4,2186,50.54894785
E02000756,Redbridge 006,2586,1772,712,179,9,5258,50.81780145
E02000757,Redbridge 007,2978,1590,494,106,11,5179,42.49855184
E02000758,Redbridge 008,1035,828,347,101,5,2316,55.31088083
E02000759,Redbridge 009,2502,1600,566,137,13,4818,48.06973848
E02000760,Redbridge 010,1128,957,432,109,3,2629,57.09395207
E02000762,Redbridge 012,1006,748,305,46,3,2108,52.27703985
E02000763,Redbridge 013,1197,884,397,92,7,2577,53.55064028
E02000764,Redbridge 014,3056,1637,552,113,10,5368,43.07004471
E02000765,Redbridge 015,1119,903,328,66,10,2426,53.87469085
E02000767,Redbridge 017,1340,974,369,81,4,2768,51.58959538
E02000768,Redbridge 018,1319,668,176,40,2,2205,40.1814059
E02000770,Redbridge 020,1030,928,407,112,12,2489,58.61791884
E02000772,Redbridge 022,1037,958,415,121,7,2538,59.14105595
E02000773,Redbridge 023,1405,1039,469,178,22,3113,54.86668808
E02000774,Redbridge 024,988,922,425,118,6,2459,59.82106547
E02000776,Redbridge 026,862,766,364,83,6,2081,58.57760692
E02000777,Redbridge 027,1244,739,271,64,8,2326,46.51762683
E02000779,Redbridge 029,879,1149,572,155,21,2776,68.33573487
E02000781,Redbridge 031,1904,1590,755,168,11,4428,57.00090334
E02000782,Redbridge 032,1390,1320,665,188,14,3577,61.14062063
E02000783,Redbridge 033,708,808,451,140,8,2115,66.5248227
E02000784,Richmond upon Thames 001,2610,1102,360,98,6,4176,37.5
E02000785,Richmond upon Thames 002,2798,1077,246,39,2,4162,32.77270543
E02000786,Richmond upon Thames 003,3121,1300,414,104,5,4944,36.87297735
E02000787,Richmond upon Thames 004,3118,1409,500,136,11,5174,39.73714727
E02000788,Richmond upon Thames 005,2338,1010,220,46,10,3624,35.48565121
E02000789,Richmond upon Thames 006,1790,770,216,58,8,2842,37.01618578
E02000790,Richmond upon Thames 007,1856,687,137,22,2,2704,31.36094675
E02000791,Richmond upon Thames 008,1973,790,170,32,4,2969,33.5466487
E02000792,Richmond upon Thames 009,1988,867,203,42,0,3100,35.87096774
E02000793,Richmond upon Thames 010,1671,1019,348,89,7,3134,46.68155712
E02000794,Richmond upon Thames 011,1773,789,167,28,2,2759,35.73758608
E02000795,Richmond upon Thames 012,1645,700,198,43,2,2588,36.4374034
E02000796,Richmond upon Thames 013,1851,1374,608,137,11,3981,53.50414469
E02000797,Richmond upon Thames 014,2254,910,265,47,1,3477,35.17400058
E02000798,Richmond upon Thames 015,2591,1226,381,122,4,4324,40.0786309
E02000799,Richmond upon Thames 016,1555,640,214,29,1,2439,36.24436244
E02000800,Richmond upon Thames 017,1154,647,254,85,17,2157,46.4997682
E02000801,Richmond upon Thames 018,1940,827,203,47,4,3021,35.78285336
E02000802,Richmond upon Thames 019,1849,843,227,53,4,2976,37.86962366
E02000803,Richmond upon Thames 020,2021,1325,564,179,7,4096,50.65917969
E02000804,Richmond upon Thames 021,2001,850,260,52,6,3169,36.8570527
E02000805,Richmond upon Thames 022,2793,1303,425,108,4,4633,39.71508742
E02000806,Richmond upon Thames 023,2571,1180,413,82,10,4256,39.59116541
E02000807,Southwark 001,2246,1052,340,93,5,3736,39.88222698
E02000808,Southwark 002,2727,1300,520,139,10,4696,41.92930153
E02000810,Southwark 004,2606,1725,766,281,17,5395,51.69601483
E02000812,Southwark 006,2094,1471,708,244,16,4533,53.80542687
E02000813,Southwark 007,2065,1491,669,241,17,4483,53.93709569
E02000814,Southwark 008,2635,1345,477,121,11,4589,42.58008281
E02000815,Southwark 009,1731,1020,365,111,6,3233,46.45839777
E02000816,Southwark 010,1712,1409,732,272,21,4146,58.70718765
E02000817,Southwark 011,986,1082,603,241,14,2926,66.30211893
E02000818,Southwark 012,2168,1415,677,213,16,4489,51.70416574
E02000819,Southwark 013,1267,1295,721,248,24,3555,64.36005626
E02000820,Southwark 014,1928,1387,677,224,12,4228,54.39924314
E02000821,Southwark 015,1108,1187,646,183,8,3132,64.62324393
E02000822,Southwark 016,979,1082,525,174,13,2773,64.69527587
E02000823,Southwark 017,1500,1254,661,205,14,3634,58.72317006
E02000824,Southwark 018,1349,1411,779,236,16,3791,64.41572145
E02000825,Southwark 019,1458,1415,748,256,14,3891,62.52891288
E02000826,Southwark 020,1785,1315,683,226,14,4023,55.63012677
E02000827,Southwark 021,2057,1864,831,254,13,5019,59.01574019
E02000828,Southwark 022,1405,1261,710,207,11,3594,60.90706733
E02000829,Southwark 023,2004,1554,851,295,33,4737,57.69474351
E02000830,Southwark 024,2033,1136,461,124,9,3763,45.97395695
E02000831,Southwark 025,2149,1215,525,154,9,4052,46.96446199
E02000832,Southwark 026,1742,1333,757,254,14,4100,57.51219512
E02000833,Southwark 027,1472,970,450,143,11,3046,51.67432699
E02000834,Southwark 028,2422,1093,455,124,9,4103,40.97002194
E02000835,Southwark 029,1635,888,395,100,12,3030,46.03960396
E02000836,Southwark 030,2066,880,307,80,4,3337,38.08810309
E02000837,Southwark 031,2058,854,187,49,2,3150,34.66666667
E02000838,Southwark 032,2209,1149,435,122,11,3926,43.73408049
E02000839,Southwark 033,1877,1029,385,133,4,3428,45.24504084
E02000840,Sutton 001,1296,1193,717,254,15,3475,62.70503597
E02000841,Sutton 002,1204,1231,647,205,14,3301,63.52620418
E02000842,Sutton 003,1511,1042,330,74,1,2958,48.91818796
E02000843,Sutton 004,2193,1205,454,120,9,3981,44.91333836
E02000844,Sutton 005,1456,1085,519,150,7,3217,54.74044141
E02000845,Sutton 006,2048,1107,369,80,4,3608,43.23725055
E02000846,Sutton 007,1483,924,332,47,0,2786,46.7695621
E02000847,Sutton 008,2001,1180,433,64,4,3682,45.65453558
E02000848,Sutton 009,1606,962,294,50,3,2915,44.90566038
E02000849,Sutton 010,1617,1112,418,96,8,3251,50.26145801
E02000850,Sutton 011,2121,1333,514,115,6,4089,48.12912693
E02000851,Sutton 012,2264,1787,750,205,29,5035,55.0347567
E02000852,Sutton 013,1702,1101,367,76,4,3250,47.63076923
E02000853,Sutton 014,1683,1025,398,93,3,3202,47.43910056
E02000854,Sutton 015,1750,929,322,74,10,3085,43.273906
E02000855,Sutton 016,1821,1032,304,53,2,3212,43.30635118
E02000856,Sutton 017,1990,1292,421,87,10,3800,47.63157895
E02000857,Sutton 018,2145,1370,460,95,10,4080,47.42647059
E02000858,Sutton 019,1194,1178,680,245,12,3309,63.91659112
E02000859,Sutton 020,1762,1189,428,103,7,3489,49.49842362
E02000860,Sutton 021,1885,1428,621,159,26,4119,54.23646516
E02000861,Sutton 022,1763,863,213,24,0,2863,38.42123647
E02000863,Sutton 024,1372,755,256,41,1,2425,43.42268041
E02000864,Tower Hamlets 001,2192,1323,816,307,26,4664,53.00171527
E02000865,Tower Hamlets 002,1135,911,576,248,24,2894,60.78092605
E02000866,Tower Hamlets 003,1982,1293,657,208,12,4152,52.26396917
E02000867,Tower Hamlets 004,2433,1513,678,221,26,4871,50.05132416
E02000868,Tower Hamlets 005,1324,888,402,160,11,2785,52.45960503
E02000869,Tower Hamlets 006,1106,797,408,193,20,2524,56.18066561
E02000870,Tower Hamlets 007,915,878,455,160,14,2422,62.22130471
E02000871,Tower Hamlets 008,1719,1410,807,273,19,4228,59.34247871
E02000872,Tower Hamlets 009,1491,979,522,184,18,3194,53.3187226
E02000873,Tower Hamlets 010,1183,969,525,233,11,2921,59.50017117
E02000874,Tower Hamlets 011,934,842,502,222,24,2524,62.99524564
E02000875,Tower Hamlets 012,2086,1639,890,425,39,5079,58.92892302
E02000876,Tower Hamlets 013,1094,949,492,221,21,2777,60.60496939
E02000877,Tower Hamlets 014,2169,1590,836,302,16,4913,55.8518217
E02000878,Tower Hamlets 015,1900,1242,603,245,21,4011,52.63026677
E02000879,Tower Hamlets 016,1077,1060,681,221,10,3049,64.67694326
E02000880,Tower Hamlets 017,809,828,465,163,16,2281,64.53309952
E02000881,Tower Hamlets 018,1604,1237,708,296,7,3852,58.35929387
E02000882,Tower Hamlets 019,1462,1252,763,315,16,3808,61.60714286
E02000883,Tower Hamlets 020,1016,1057,667,275,15,3030,66.46864686
E02000884,Tower Hamlets 021,2635,1661,611,186,22,5115,48.48484848
E02000885,Tower Hamlets 022,760,857,534,223,17,2391,68.21413634
E02000886,Tower Hamlets 023,1937,1120,559,194,15,3825,49.35947712
E02000887,Tower Hamlets 024,1551,1344,749,283,21,3948,60.71428571
E02000888,Tower Hamlets 025,1629,1072,467,174,10,3352,51.40214797
E02000889,Tower Hamlets 026,2065,1195,407,131,10,3808,45.77205882
E02000890,Tower Hamlets 027,1826,753,245,63,4,2891,36.8384642
E02000893,Tower Hamlets 030,1315,983,491,175,25,2989,56.00535296
E02000894,Tower Hamlets 031,2394,1389,530,143,7,4463,46.35895138
E02000895,Waltham Forest 001,1407,1133,585,144,8,3277,57.06438816
E02000896,Waltham Forest 002,2015,1279,451,86,7,3838,47.49869724
E02000897,Waltham Forest 003,1439,1125,602,188,15,3369,57.28702879
E02000898,Waltham Forest 004,1401,1076,564,141,19,3201,56.23242737
E02000899,Waltham Forest 005,1463,1106,525,122,10,3226,54.64972102
E02000900,Waltham Forest 006,1297,1117,532,162,11,3119,58.41615903
E02000901,Waltham Forest 007,2101,1168,466,107,10,3852,45.4569055
E02000902,Waltham Forest 008,1621,1234,508,143,12,3518,53.92268334
E02000903,Waltham Forest 009,1425,1151,665,207,17,3465,58.87445887
E02000904,Waltham Forest 010,1618,996,385,106,2,3107,47.92404248
E02000905,Waltham Forest 011,1782,1228,492,119,9,3630,50.90909091
E02000906,Waltham Forest 012,1739,1171,554,155,8,3627,52.05403915
E02000907,Waltham Forest 013,1505,1453,803,284,23,4068,63.00393314
E02000908,Waltham Forest 014,2645,1684,708,190,13,5240,49.52290076
E02000909,Waltham Forest 015,1821,1112,491,133,12,3569,48.97730457
E02000910,Waltham Forest 016,2119,1444,662,161,20,4406,51.90649115
E02000911,Waltham Forest 017,2232,1580,809,211,16,4848,53.96039604
E02000912,Waltham Forest 018,1437,1089,557,179,11,3273,56.09532539
E02000913,Waltham Forest 019,1354,1094,538,113,15,3114,56.51894669
E02000914,Waltham Forest 020,1370,1431,873,276,25,3975,65.53459119
E02000915,Waltham Forest 021,1586,1117,450,122,8,3283,51.69052696
E02000916,Waltham Forest 022,1788,1389,625,161,19,3982,55.09794073
E02000917,Waltham Forest 023,1765,1189,528,160,8,3650,51.64383562
E02000918,Waltham Forest 024,1498,1157,553,186,14,3408,56.04460094
E02000919,Waltham Forest 025,1543,1160,512,131,11,3357,54.03634197
E02000920,Waltham Forest 026,1531,1365,689,217,14,3816,59.87945493
E02000921,Waltham Forest 027,1500,1471,823,238,26,4058,63.03597831
E02000922,Waltham Forest 028,1574,1269,614,160,18,3635,56.69876204
E02000923,Wandsworth 001,2092,994,307,70,6,3469,39.69443644
E02000925,Wandsworth 003,1582,1054,535,171,21,3363,52.95866786
E02000926,Wandsworth 004,3486,1483,471,103,9,5552,37.21181556
E02000927,Wandsworth 005,1674,945,453,152,11,3235,48.25347759
E02000928,Wandsworth 006,2379,913,263,59,0,3614,34.17266187
E02000929,Wandsworth 007,1441,1086,693,242,33,3495,58.76967096
E02000930,Wandsworth 008,2725,1061,378,88,10,4262,36.06288128
E02000931,Wandsworth 009,2456,781,197,46,7,3487,29.56696301
E02000932,Wandsworth 010,4144,1329,365,83,7,5928,30.09446694
E02000933,Wandsworth 011,2444,1086,319,77,6,3932,37.84333672
E02000934,Wandsworth 012,2654,1092,339,95,16,4196,36.74928503
E02000935,Wandsworth 013,831,923,498,170,13,2435,65.87268994
E02000936,Wandsworth 014,2644,1243,376,109,12,4384,39.68978102
E02000937,Wandsworth 015,2112,753,200,57,5,3127,32.4592261
E02000938,Wandsworth 016,2181,1336,627,179,22,4345,49.80437284
E02000939,Wandsworth 017,1962,664,174,31,4,2835,30.79365079
E02000940,Wandsworth 018,2419,1192,443,148,12,4214,42.59610821
E02000941,Wandsworth 019,2577,1094,372,88,8,4139,37.7385842
E02000942,Wandsworth 020,2472,1021,270,43,10,3816,35.22012579
E02000943,Wandsworth 021,2467,944,300,89,10,3810,35.24934383
E02000944,Wandsworth 022,1346,953,436,140,16,2891,53.44171567
E02000945,Wandsworth 023,1047,1004,533,163,17,2764,62.12011577
E02000946,Wandsworth 024,1841,825,327,107,4,3104,40.68943299
E02000947,Wandsworth 025,2596,948,294,72,7,3917,33.72478938
E02000948,Wandsworth 026,2790,1152,353,82,5,4382,36.33044272
E02000949,Wandsworth 027,2852,1066,276,56,5,4255,32.97297297
E02000950,Wandsworth 028,1727,953,324,96,10,3110,44.46945338
E02000951,Wandsworth 029,1608,799,319,83,13,2822,43.01913536
E02000952,Wandsworth 030,1482,761,303,102,6,2654,44.15975885
E02000953,Wandsworth 031,2095,765,264,80,7,3211,34.75552787
E02000954,Wandsworth 032,1287,614,275,59,12,2247,42.72363151
E02000955,Wandsworth 033,1363,798,376,131,8,2676,49.06576981
E02000956,Wandsworth 034,1468,980,417,161,7,3033,51.59907682
E02000957,Wandsworth 035,2351,1301,588,166,14,4420,46.80995475
E02000958,Wandsworth 036,1471,953,401,83,9,2917,49.57147755
E02000959,Wandsworth 037,1475,1012,459,144,14,3104,52.4806701
E02000960,Westminster 001,1617,800,278,71,16,2782,41.87634795
E02000961,Westminster 002,2093,1220,509,221,25,4068,48.54965585
E02000962,Westminster 003,2009,1153,491,188,16,3857,47.91288566
E02000963,Westminster 004,1447,1360,869,437,21,4134,64.99758104
E02000964,Westminster 005,2115,1746,994,454,48,5357,60.51894717
E02000965,Westminster 006,2063,1016,385,142,16,3622,43.04251795
E02000966,Westminster 007,2386,1139,378,183,24,4110,41.94647202
E02000967,Westminster 008,1893,834,238,47,2,3014,37.19309887
E02000968,Westminster 009,1496,1835,1439,760,87,5617,73.36656578
E02000969,Westminster 010,1227,1198,850,385,58,3718,66.99838623
E02000970,Westminster 011,2264,1009,232,48,2,3555,36.31504923
E02000971,Westminster 012,2146,1062,365,123,28,3724,42.37379162
E02000972,Westminster 013,2154,1400,504,159,37,4254,49.36530324
E02000973,Westminster 014,2458,1490,597,219,33,4797,48.75964144
E02000974,Westminster 015,2136,1177,452,183,33,3981,46.34513941
E02000975,Westminster 016,2071,1236,363,108,22,3800,45.5
E02000976,Westminster 017,2130,1367,527,160,29,4213,49.44220271
E02000977,Westminster 018,1977,972,363,100,23,3435,42.44541485
E02000978,Westminster 019,1965,665,113,20,1,2764,28.90738061
E02000979,Westminster 020,2218,1116,423,142,28,3927,43.51922587
E02000980,Westminster 021,1933,1370,711,268,42,4324,55.2960222
E02000981,Westminster 022,2348,1213,426,153,15,4155,43.48977136
E02000982,Westminster 023,1790,1205,580,228,42,3845,53.44603381
E02000983,Westminster 024,1605,1254,637,227,34,3757,57.27974448
E02003237,Peterborough 001,1411,911,293,48,5,2668,47.11394303
E02003238,Peterborough 002,1219,787,340,113,10,2469,50.62778453
E02003239,Peterborough 003,1843,1237,401,62,3,3546,48.02594473
E02003240,Peterborough 004,1609,815,245,38,1,2708,40.58345643
E02003241,Peterborough 005,1455,1063,444,86,3,3051,52.3107178
E02003242,Peterborough 006,1624,1368,619,150,9,3770,56.92307692
E02003243,Peterborough 007,1719,1697,1010,360,26,4812,64.27680798
E02003244,Peterborough 008,1230,1434,834,265,25,3788,67.52903907
E02003245,Peterborough 009,990,1196,629,225,18,3058,67.62589928
E02003246,Peterborough 010,1051,1285,645,209,11,3201,67.16651047
E02003247,Peterborough 011,1395,1279,635,177,16,3502,60.16561965
E02003248,Peterborough 012,1266,1360,639,187,13,3465,63.46320346
E02003249,Peterborough 013,1964,1884,884,266,23,5021,60.884286
E02003250,Peterborough 014,1738,1801,859,277,18,4693,62.96611975
E02003251,Peterborough 015,1596,1084,328,46,3,3057,47.79195289
E02003252,Peterborough 016,2360,1593,626,171,13,4763,50.45139618
E02003253,Peterborough 017,2086,1590,673,185,8,4542,54.07309555
E02003254,Peterborough 018,2301,1258,448,56,4,4067,43.42267027
E02003255,Peterborough 019,2786,1811,800,186,4,5587,50.1342402
E02003257,Peterborough 021,1291,1382,824,240,36,3773,65.7831964
E02003258,Luton 001,1882,1191,362,49,4,3488,46.04357798
E02003259,Luton 002,1210,958,357,80,2,2607,53.58649789
E02003260,Luton 003,1130,1212,661,227,27,3257,65.30549586
E02003261,Luton 004,1087,906,387,95,1,2476,56.09854604
E02003262,Luton 005,1544,1452,774,282,14,4066,62.02656173
E02003263,Luton 006,1915,1685,714,165,9,4488,57.33065954
E02003264,Luton 007,1763,1087,292,59,1,3202,44.94066209
E02003265,Luton 008,1673,1197,500,116,12,3498,52.1726701
E02003266,Luton 009,1308,1326,778,227,15,3654,64.20361248
E02003267,Luton 010,1383,1387,692,214,9,3685,62.46947083
E02003268,Luton 011,1519,1416,649,157,5,3746,59.45008009
E02003269,Luton 012,2027,1507,557,107,6,4204,51.78401522
E02003270,Luton 013,1357,1155,476,100,3,3091,56.09835005
E02003271,Luton 014,2137,1303,488,86,9,4023,46.88043748
E02003272,Luton 015,961,1052,606,190,20,2829,66.03039943
E02003273,Luton 016,1962,1483,678,183,5,4311,54.48851775
E02003274,Luton 017,962,1241,866,262,32,3363,71.39458817
E02003276,Luton 019,960,1030,545,169,24,2728,64.80938416
E02003277,Luton 020,1345,1492,858,253,19,3967,66.09528611
E02003278,Luton 021,2040,1980,895,292,48,5255,61.17982873
E02003279,Southend-on-Sea 001,1894,1533,529,95,7,4058,53.32676195
E02003280,Southend-on-Sea 002,1899,1650,766,158,7,4480,57.61160714
E02003281,Southend-on-Sea 003,1856,1540,641,145,19,4201,55.82004285
E02003282,Southend-on-Sea 004,2073,1499,674,176,20,4442,53.33183251
E02003283,Southend-on-Sea 005,2025,1527,668,210,16,4446,54.4534413
E02003284,Southend-on-Sea 006,1931,1647,815,227,20,4640,58.38362069
E02003285,Southend-on-Sea 007,2190,1540,702,179,17,4628,52.67934313
E02003286,Southend-on-Sea 008,2348,1160,313,33,2,3856,39.10788382
E02003287,Southend-on-Sea 009,1784,1438,726,227,19,4194,57.46304244
E02003288,Southend-on-Sea 010,2423,2026,1118,382,25,5974,59.44091061
E02003289,Southend-on-Sea 011,2774,1435,426,66,7,4708,41.07901444
E02003290,Southend-on-Sea 012,2284,1479,513,170,26,4472,48.92665474
E02003291,Southend-on-Sea 013,2057,1846,937,284,17,5141,59.98832912
E02003292,Southend-on-Sea 014,2037,1936,1097,429,57,5556,63.33693305
E02003293,Southend-on-Sea 015,2309,2065,966,286,45,5671,59.28407688
E02003294,Southend-on-Sea 016,2021,1403,472,55,3,3954,48.88720283
E02003295,Southend-on-Sea 017,1808,1336,616,154,11,3925,53.93630573
E02003296,Thurrock 001,1343,1004,367,44,4,2762,51.37581463
E02003297,Thurrock 002,1240,1051,501,115,7,2914,57.44680851
E02003298,Thurrock 003,1192,1047,501,86,6,2832,57.90960452
E02003299,Thurrock 004,1294,844,284,35,0,2457,47.33414733
E02003300,Thurrock 005,1803,1202,480,94,9,3588,49.74916388
E02003301,Thurrock 006,2056,1519,733,187,17,4512,54.43262411
E02003302,Thurrock 007,1476,1440,799,282,27,4024,63.32007952
E02003303,Thurrock 008,1588,1197,578,166,11,3540,55.14124294
E02003304,Thurrock 009,1407,1316,734,178,5,3640,61.34615385
E02003305,Thurrock 010,1244,976,371,56,9,2656,53.1626506
E02003307,Thurrock 012,1404,1486,828,229,15,3962,64.56335184
E02003308,Thurrock 013,1390,960,368,83,4,2805,50.4456328
E02003309,Thurrock 014,1421,1062,438,78,3,3002,52.66489007
E02003311,Thurrock 016,1713,1185,440,101,4,3443,50.24687772
E02003312,Thurrock 017,1671,1348,567,164,18,3768,55.65286624
E02003313,Thurrock 018,1894,1890,1046,364,21,5215,63.68168744
E02003314,Medway 001,1165,1066,508,115,9,2863,59.30841774
E02003315,Medway 002,1168,743,271,42,4,2228,47.57630162
E02003316,Medway 003,2352,1579,611,112,10,4664,49.57118353
E02003317,Medway 004,1406,892,360,92,6,2756,48.98403483
E02003318,Medway 005,1182,810,247,39,5,2283,48.2260184
E02003319,Medway 006,1541,1090,511,140,17,3299,53.28887542
E02003320,Medway 007,1961,1173,482,156,19,3791,48.27222369
E02003321,Medway 008,964,898,470,155,8,2495,61.36272545
E02003322,Medway 009,1392,1047,509,168,21,3137,55.62639464
E02003323,Medway 010,1245,931,487,150,9,2822,55.88235294
E02003324,Medway 011,1812,1310,575,150,14,3861,53.06915307
E02003325,Medway 012,1086,1161,560,178,23,3008,63.8962766
E02003326,Medway 013,1280,1006,511,151,16,2964,56.81511471
E02003327,Medway 014,1810,1192,497,143,20,3662,50.57345713
E02003328,Medway 015,1731,1493,786,293,27,4330,60.02309469
E02003329,Medway 016,1164,974,404,96,5,2643,55.95913734
E02003330,Medway 017,1361,909,353,100,9,2732,50.18301611
E02003331,Medway 018,1389,1283,746,208,42,3668,62.13195202
E02003332,Medway 019,1075,837,304,90,7,2313,53.52356247
E02003333,Medway 020,970,1028,563,205,21,2787,65.19555077
E02003334,Medway 021,1030,838,330,103,10,2311,55.43054955
E02003335,Medway 022,1042,924,556,169,9,2700,61.40740741
E02003336,Medway 023,1259,928,376,67,5,2635,52.22011385
E02003337,Medway 024,1284,932,362,95,3,2676,52.01793722
E02003338,Medway 025,1436,1112,498,112,16,3174,54.75740391
E02003339,Medway 026,1218,842,299,68,6,2433,49.93834772
E02003340,Medway 027,1256,1127,635,193,7,3218,60.9695463
E02003341,Medway 028,1419,879,299,60,4,2661,46.67418264
E02003342,Medway 029,1271,875,341,80,3,2570,50.54474708
E02003343,Medway 030,1276,814,252,34,0,2376,46.2962963
E02003344,Medway 031,1149,941,456,139,13,2698,57.41289844
E02003345,Medway 032,1420,794,206,33,0,2453,42.11169996
E02003346,Medway 033,1426,959,401,80,10,2876,50.41724618
E02003347,Medway 034,1361,776,259,37,3,2436,44.12972085
E02003348,Medway 035,1797,1083,280,30,1,3191,43.68536509
E02003349,Medway 036,1490,1103,411,61,3,3068,51.43415906
E02003350,Medway 037,1107,911,396,94,6,2514,55.96658711
E02003351,Medway 038,1514,1154,410,88,1,3167,52.19450584
E02003352,Bracknell Forest 001,1425,806,242,29,3,2505,43.11377246
E02003353,Bracknell Forest 002,3292,1247,345,51,1,4936,33.30632091
E02003354,Bracknell Forest 003,2594,1167,312,54,2,4129,37.17607169
E02003355,Bracknell Forest 004,1324,994,407,139,14,2878,53.99583044
E02003356,Bracknell Forest 005,1794,798,240,18,0,2850,37.05263158
E02003357,Bracknell Forest 006,2200,1421,556,143,9,4329,49.17994918
E02003358,Bracknell Forest 007,2616,1642,598,161,21,5038,48.07463279
E02003359,Bracknell Forest 008,1575,877,282,56,7,2797,43.6896675
E02003360,Bracknell Forest 009,2329,1428,488,88,2,4335,46.2745098
E02003361,Bracknell Forest 010,1518,1035,418,100,5,3076,50.65019506
E02003362,Bracknell Forest 011,1354,937,353,80,10,2734,50.47549378
E02003363,Bracknell Forest 012,1608,813,224,26,1,2672,39.82035928
E02003364,Bracknell Forest 013,1650,802,214,44,2,2712,39.15929204
E02003365,Bracknell Forest 014,1625,843,225,48,3,2744,40.77988338
E02003366,Bracknell Forest 015,1427,831,228,34,0,2520,43.37301587
E02003367,West Berkshire 001,1503,747,195,27,4,2476,39.29725363
E02003368,West Berkshire 002,1356,839,262,45,3,2505,45.86826347
E02003369,West Berkshire 003,1618,729,195,23,1,2566,36.94466095
E02003370,West Berkshire 004,1642,816,231,29,1,2719,39.61015079
E02003371,West Berkshire 005,1296,782,242,27,1,2348,44.80408859
E02003372,West Berkshire 006,1622,1054,368,48,0,3092,47.54204398
E02003373,West Berkshire 007,1925,863,219,29,6,3042,36.71926364
E02003374,West Berkshire 008,1352,768,259,67,4,2450,44.81632653
E02003375,West Berkshire 009,1455,853,310,64,9,2691,45.93088071
E02003376,West Berkshire 010,1410,922,299,57,3,2691,47.60312152
E02003377,West Berkshire 011,2309,1237,362,63,0,3971,41.85343742
E02003378,West Berkshire 012,1807,1215,472,97,6,3597,49.76369197
E02003379,West Berkshire 013,1468,919,349,89,5,2830,48.12720848
E02003380,West Berkshire 014,1852,1093,349,65,1,3360,44.88095238
E02003381,West Berkshire 015,1409,731,201,36,1,2378,40.74852817
E02003382,West Berkshire 016,1485,1115,473,126,7,3206,53.68059888
E02003383,West Berkshire 017,1579,883,257,42,3,2764,42.87264834
E02003384,West Berkshire 018,1630,828,209,41,2,2710,39.85239852
E02003385,West Berkshire 019,3085,1575,519,163,8,5350,42.3364486
E02003386,West Berkshire 020,1856,1170,483,137,13,3659,49.2757584
E02003387,West Berkshire 021,2227,1168,309,43,2,3749,40.59749266
E02003388,West Berkshire 022,1435,752,264,45,1,2497,42.53103724
E02003389,Reading 001,1867,1031,252,38,2,3190,41.47335423
E02003390,Reading 002,1921,801,161,11,0,2894,33.62128542
E02003391,Reading 003,2040,1025,294,49,1,3409,40.15840422
E02003392,Reading 004,2089,1101,462,105,9,3766,44.53000531
E02003393,Reading 005,1857,1070,306,44,0,3277,43.33231614
E02003394,Reading 006,1453,1075,517,147,12,3204,54.65043695
E02003395,Reading 007,2198,1384,547,154,13,4296,48.83612663
E02003396,Reading 008,2014,1379,521,146,11,4071,50.52812577
E02003397,Reading 009,1417,1122,528,167,14,3248,56.37315271
E02003398,Reading 010,2159,1373,575,155,12,4274,49.48525971
E02003400,Reading 012,1699,994,311,79,8,3091,45.03396959
E02003401,Reading 013,1952,1233,509,144,17,3855,49.36446174
E02003402,Reading 014,2203,1252,492,105,8,4060,45.73891626
E02003403,Reading 015,1677,1324,612,197,14,3824,56.14539749
E02003404,Reading 016,908,820,403,130,16,2277,60.12296882
E02003405,Reading 017,2156,1572,838,316,27,4909,56.08066816
E02003406,Reading 018,1251,1075,568,145,10,3049,58.97015415
E02003407,Slough 001,1402,1378,680,223,26,3709,62.20005392
E02003408,Slough 002,1284,1375,654,197,14,3524,63.56413167
E02003409,Slough 003,1876,1402,576,124,7,3985,52.92346299
E02003410,Slough 004,1167,1326,674,221,12,3400,65.67647059
E02003411,Slough 005,1382,1418,723,211,9,3743,63.07774512
E02003412,Slough 006,1768,1256,494,97,5,3620,51.16022099
E02003414,Slough 008,2176,1669,686,182,20,4733,54.02493133
E02003415,Slough 009,1536,1646,823,238,17,4260,63.94366197
E02003416,Slough 010,1718,1142,377,73,3,3313,48.14367643
E02003417,Slough 011,2098,1650,675,147,15,4585,54.24209378
E02003418,Slough 012,1439,1201,547,172,14,3373,57.33768159
E02003419,Slough 013,1366,1122,527,125,5,3145,56.56597774
E02003420,Slough 014,1080,851,364,88,12,2395,54.90605428
E02003421,Windsor and Maidenhead 001,1270,656,189,33,2,2150,40.93023256
E02003422,Windsor and Maidenhead 002,3071,1382,334,66,5,4858,36.78468506
E02003423,Windsor and Maidenhead 003,1214,757,329,77,4,2381,49.01301974
E02003424,Windsor and Maidenhead 004,2616,1029,230,20,4,3899,32.9058733
E02003425,Windsor and Maidenhead 005,3080,1696,671,167,4,5618,45.1762193
E02003426,Windsor and Maidenhead 006,2361,1094,273,39,1,3768,37.34076433
E02003427,Windsor and Maidenhead 007,1568,975,404,88,3,3038,48.38709677
E02003428,Windsor and Maidenhead 008,1999,1114,369,74,6,3562,43.87984278
E02003429,Windsor and Maidenhead 009,1812,895,222,29,1,2959,38.76309564
E02003430,Windsor and Maidenhead 010,1528,764,257,39,0,2588,40.95826893
E02003431,Windsor and Maidenhead 011,1510,883,322,69,10,2794,45.95561918
E02003432,Windsor and Maidenhead 012,1934,875,283,46,1,3139,38.38802166
E02003433,Windsor and Maidenhead 013,1404,919,285,57,3,2668,47.37631184
E02003434,Windsor and Maidenhead 014,2008,1139,504,117,5,3773,46.77975086
E02003435,Windsor and Maidenhead 015,1912,807,187,23,0,2929,34.72174804
E02003436,Windsor and Maidenhead 016,1982,1116,345,56,1,3500,43.37142857
E02003437,Windsor and Maidenhead 017,1820,872,225,39,1,2957,38.4511329
E02003438,Windsor and Maidenhead 018,2839,1186,295,32,1,4353,34.78061107
E02003439,Wokingham 001,1419,655,216,27,3,2320,38.8362069
E02003440,Wokingham 002,2369,1105,271,37,1,3783,37.37774253
E02003441,Wokingham 003,1746,962,268,39,1,3016,42.10875332
E02003442,Wokingham 004,2190,914,209,18,3,3334,34.31313737
E02003443,Wokingham 005,1247,982,450,102,3,2784,55.20833333
E02003444,Wokingham 006,1863,1057,304,53,3,3280,43.20121951
E02003445,Wokingham 007,1948,1115,317,39,4,3423,43.09085597
E02003446,Wokingham 008,1916,978,215,21,0,3130,38.78594249
E02003447,Wokingham 009,2466,1086,325,65,6,3948,37.53799392
E02003448,Wokingham 010,2034,890,195,16,2,3137,35.16098183
E02003449,Wokingham 011,1949,945,219,37,1,3151,38.14662012
E02003450,Wokingham 012,3161,1375,400,70,7,5013,36.94394574
E02003451,Wokingham 013,2447,1406,556,117,9,4535,46.04189636
E02003452,Wokingham 014,2468,973,219,34,0,3694,33.18895506
E02003453,Wokingham 015,1808,710,122,15,0,2655,31.90207156
E02003454,Wokingham 016,2264,1003,256,40,6,3569,36.56486411
E02003455,Wokingham 017,2794,1090,277,51,4,4216,33.72865275
E02003456,Wokingham 018,1950,892,268,58,5,3173,38.5439647
E02003457,Wokingham 019,2464,1073,220,32,3,3792,35.02109705
E02003458,Wokingham 020,2015,962,208,28,3,3216,37.34452736
E02003459,Milton Keynes 001,2325,1165,339,50,2,3881,40.0927596
E02003460,Milton Keynes 002,2893,1477,408,62,2,4842,40.251962
E02003461,Milton Keynes 003,1581,1014,368,55,1,3019,47.63166611
E02003462,Milton Keynes 004,2040,1068,330,49,7,3494,41.61419576
E02003463,Milton Keynes 005,1345,939,376,77,7,2744,50.98396501
E02003464,Milton Keynes 006,1038,970,503,159,7,2677,61.22525215
E02003465,Milton Keynes 007,1350,948,381,52,0,2731,50.56755767
E02003466,Milton Keynes 008,1648,988,367,90,4,3097,46.78721343
E02003467,Milton Keynes 009,1047,918,477,121,8,2571,59.27654609
E02003468,Milton Keynes 010,1955,1274,457,82,3,3771,48.15698754
E02003469,Milton Keynes 011,1247,843,275,52,0,2417,48.40711626
E02003470,Milton Keynes 012,666,825,513,207,23,2234,70.18800358
E02003471,Milton Keynes 013,1106,918,424,121,7,2576,57.06521739
E02003472,Milton Keynes 014,2085,1454,671,225,26,4461,53.26160054
E02003473,Milton Keynes 015,1256,775,271,34,4,2340,46.32478632
E02003474,Milton Keynes 016,1787,1171,368,84,6,3416,47.68735363
E02003476,Milton Keynes 018,1095,1212,644,211,15,3177,65.53352219
E02003478,Milton Keynes 020,1501,850,293,71,1,2716,44.73490427
E02003479,Milton Keynes 021,1164,1024,504,163,12,2867,59.40006976
E02003480,Milton Keynes 022,1858,1085,394,92,8,3437,45.94122781
E02003481,Milton Keynes 023,1135,1150,732,306,37,3360,66.2202381
E02003482,Milton Keynes 024,2214,1081,267,49,1,3612,38.70431894
E02003483,Milton Keynes 025,2461,1099,348,105,6,4019,38.76586215
E02003484,Milton Keynes 026,1449,976,391,94,6,2916,50.30864198
E02003485,Milton Keynes 027,1358,1176,551,133,5,3223,57.86534285
E02003486,Milton Keynes 028,2298,1079,335,83,5,3800,39.52631579
E02003487,Milton Keynes 029,1301,1068,473,104,7,2953,55.9431087
E02003488,Milton Keynes 030,1376,1269,570,118,11,3344,58.85167464
E02003489,Milton Keynes 031,1510,1082,455,75,2,3124,51.66453265
E02003490,Milton Keynes 032,1794,1324,648,207,18,3991,55.04885993
E02003491,Brighton and Hove 001,1524,1008,422,96,5,3055,50.11456628
E02003492,Brighton and Hove 002,676,709,496,177,20,2078,67.46871992
E02003493,Brighton and Hove 003,1888,1063,362,53,2,3368,43.94299287
E02003494,Brighton and Hove 004,1428,869,286,56,3,2642,45.95003785
E02003495,Brighton and Hove 005,1314,1041,456,131,3,2945,55.3820034
E02003496,Brighton and Hove 006,1331,1053,557,182,9,3132,57.50319285
E02003497,Brighton and Hove 007,1762,858,221,35,2,2878,38.77692842
E02003498,Brighton and Hove 008,1144,1163,767,331,32,3437,66.71515857
E02003499,Brighton and Hove 009,865,1031,644,205,15,2760,68.65942029
E02003500,Brighton and Hove 010,1821,842,242,47,2,2954,38.35477319
E02003501,Brighton and Hove 011,2167,1100,306,78,15,3666,40.88925259
E02003502,Brighton and Hove 012,1401,1081,528,185,34,3229,56.61195417
E02003503,Brighton and Hove 013,1600,1171,548,130,6,3455,53.69030391
E02003504,Brighton and Hove 014,2133,1212,437,106,11,3899,45.29366504
E02003505,Brighton and Hove 015,1826,1240,600,146,21,3833,52.36107488
E02003506,Brighton and Hove 016,1756,820,306,75,7,2964,40.75573549
E02003507,Brighton and Hove 017,1657,1445,639,155,18,3914,57.66479305
E02003508,Brighton and Hove 018,1774,1125,441,65,3,3408,47.94600939
E02003509,Brighton and Hove 019,2273,1455,642,204,24,4598,50.56546324
E02003510,Brighton and Hove 020,2258,1304,464,99,12,4137,45.41938603
E02003511,Brighton and Hove 021,1886,1110,419,106,7,3528,46.54195011
E02003512,Brighton and Hove 022,1855,1195,534,128,15,3727,50.22806547
E02003513,Brighton and Hove 023,1403,892,392,121,10,2818,50.21291696
E02003514,Brighton and Hove 024,2283,1611,622,183,30,4729,51.72340875
E02003515,Brighton and Hove 025,1036,1228,967,435,36,3702,72.01512696
E02003516,Brighton and Hove 026,2222,1664,635,160,22,4703,52.75356156
E02003517,Brighton and Hove 027,2547,1761,799,263,27,5397,52.80711506
E02003518,Brighton and Hove 028,2030,1397,504,167,33,4131,50.85935609
E02003519,Brighton and Hove 029,2224,1688,674,174,36,4796,53.62802335
E02003520,Brighton and Hove 030,1768,1602,888,388,45,4691,62.31080793
E02003521,Brighton and Hove 031,1942,1436,687,248,28,4341,55.26376411
E02003522,Brighton and Hove 032,1856,1261,509,179,18,3823,51.45173947
E02003523,Brighton and Hove 033,2467,1622,470,85,12,4656,47.01460481
E02003524,Portsmouth 001,1061,1070,689,229,15,3064,65.37206266
E02003525,Portsmouth 002,902,927,555,182,18,2584,65.09287926
E02003526,Portsmouth 003,1528,956,284,34,2,2804,45.5064194
E02003527,Portsmouth 004,1355,895,384,86,6,2726,50.29347029
E02003529,Portsmouth 006,1798,999,371,76,2,3246,44.60874923
E02003530,Portsmouth 007,1575,1102,474,154,13,3318,52.53164557
E02003531,Portsmouth 008,1761,1142,347,57,7,3314,46.86179843
E02003532,Portsmouth 009,1587,1117,437,106,11,3258,51.28913444
E02003533,Portsmouth 010,1016,892,454,121,3,2486,59.13113435
E02003534,Portsmouth 011,1755,1203,433,90,7,3488,49.68463303
E02003535,Portsmouth 012,1842,1289,565,122,7,3825,51.84313725
E02003536,Portsmouth 013,864,1155,888,382,40,3329,74.04626014
E02003537,Portsmouth 014,2132,1358,527,144,3,4164,48.79923151
E02003538,Portsmouth 015,1976,1470,707,178,17,4348,54.55381785
E02003540,Portsmouth 017,2035,1377,565,114,4,4095,50.30525031
E02003541,Portsmouth 018,1465,1442,976,313,30,4226,65.33364884
E02003542,Portsmouth 019,1955,1129,407,66,2,3559,45.06883956
E02003543,Portsmouth 020,1730,1219,454,107,13,3523,50.89412433
E02003544,Portsmouth 021,1581,868,316,80,3,2848,44.48735955
E02003545,Portsmouth 022,1815,1125,420,129,5,3494,48.05380653
E02003546,Portsmouth 023,2028,1175,429,83,4,3719,45.46921215
E02003547,Portsmouth 024,2333,1447,496,98,13,4387,46.82015044
E02003548,Portsmouth 025,1522,880,313,57,8,2780,45.25179856
E02003549,Southampton 001,1513,824,261,54,4,2656,43.03463855
E02003550,Southampton 002,1531,1117,489,142,9,3288,53.43673966
E02003551,Southampton 003,842,817,442,174,31,2306,63.48655681
E02003552,Southampton 004,893,987,574,182,8,2644,66.22541604
E02003553,Southampton 005,925,901,423,128,12,2389,61.28087066
E02003554,Southampton 006,1346,880,329,74,9,2638,48.97649735
E02003555,Southampton 007,1534,1287,603,173,16,3613,57.54220869
E02003556,Southampton 008,1153,850,305,65,6,2379,51.53425809
E02003557,Southampton 009,1518,891,298,43,6,2756,44.92017417
E02003558,Southampton 010,1248,1128,511,166,8,3061,59.22901013
E02003559,Southampton 011,1758,921,304,55,5,3043,42.22806441
E02003560,Southampton 012,1076,1081,632,260,15,3064,64.88250653
E02003561,Southampton 013,1352,1156,497,171,25,3201,57.763199
E02003562,Southampton 014,1927,1234,443,103,10,3717,48.15711595
E02003563,Southampton 015,1590,1216,581,160,15,3562,55.36215609
E02003564,Southampton 016,1481,1218,553,160,18,3430,56.82215743
E02003565,Southampton 017,1283,971,356,94,8,2712,52.69174041
E02003566,Southampton 018,1134,997,475,113,7,2726,58.40058694
E02003567,Southampton 019,1322,1054,532,153,5,3066,56.88193085
E02003568,Southampton 020,2008,1246,382,116,19,3771,46.75152479
E02003569,Southampton 021,1723,1254,575,166,13,3731,53.81935138
E02003570,Southampton 022,1492,1518,807,235,24,4076,63.39548577
E02003571,Southampton 023,1482,1119,480,123,13,3217,53.932235
E02003572,Southampton 024,1290,817,323,63,5,2498,48.35868695
E02003573,Southampton 025,1149,1223,722,215,15,3324,65.433213
E02003574,Southampton 026,1570,1181,540,120,17,3428,54.20070012
E02003575,Southampton 027,993,1006,610,218,11,2838,65.01057082
E02003576,Southampton 028,1515,1194,563,162,22,3456,56.16319444
E02003578,Southampton 030,1307,946,403,80,7,2743,52.35144003
E02003579,Southampton 031,2343,1314,489,121,9,4276,45.20579981
E02003580,Southampton 032,867,892,602,242,15,2618,66.88311688
E02003581,Isle of Wight 001,1879,1154,517,115,7,3672,48.82897603
E02003582,Isle of Wight 002,1942,1306,404,84,4,3740,48.07486631
E02003583,Isle of Wight 003,1581,1222,583,126,9,3521,55.09798353
E02003584,Isle of Wight 004,1289,1175,577,205,32,3278,60.67724222
E02003585,Isle of Wight 005,1488,1128,425,50,8,3099,51.98451113
E02003586,Isle of Wight 006,1514,1241,525,115,8,3403,55.50984426
E02003587,Isle of Wight 007,1546,1363,697,211,22,3839,59.72909612
E02003588,Isle of Wight 008,1521,1281,638,178,8,3626,58.05295091
E02003589,Isle of Wight 009,1436,1208,650,161,13,3468,58.5928489
E02003590,Isle of Wight 010,1712,1363,413,67,3,3558,51.88308038
E02003591,Isle of Wight 011,1855,1431,599,131,12,4028,53.94736842
E02003592,Isle of Wight 012,2134,1800,674,155,11,4774,55.29953917
E02003593,Isle of Wight 013,1192,844,304,57,3,2400,50.33333333
E02003594,Isle of Wight 014,1654,1584,770,214,14,4236,60.95372993
E02003595,Isle of Wight 015,1576,1452,561,126,1,3716,57.58880517
E02003596,Isle of Wight 016,1652,1562,764,210,24,4212,60.77872745
E02003597,Isle of Wight 017,1181,950,367,87,3,2588,54.36630603
E02003598,Isle of Wight 018,1417,1411,602,174,12,3616,60.8130531
E02003599,Central Bedfordshire 001,1177,763,303,65,8,2316,49.17962003
E02003600,Central Bedfordshire 002,1353,961,328,53,6,2701,49.90744169
E02003601,Central Bedfordshire 003,1962,1130,333,66,0,3491,43.79833858
E02003602,Central Bedfordshire 004,1433,947,291,45,0,2716,47.23858616
E02003603,Central Bedfordshire 005,2624,1612,571,152,10,4969,47.19259408
E02003604,Central Bedfordshire 006,2575,1357,463,76,5,4476,42.47095621
E02003605,Central Bedfordshire 007,2258,1187,337,43,1,3826,40.98274961
E02003606,Central Bedfordshire 008,2259,1128,378,69,1,3835,41.09517601
E02003607,Central Bedfordshire 009,2625,1366,431,86,4,4512,41.82180851
E02003608,Central Bedfordshire 010,2847,1630,565,90,2,5134,44.54616284
E02003609,Central Bedfordshire 011,2623,1456,488,94,6,4667,43.79687165
E02003610,Central Bedfordshire 012,2328,1071,294,54,0,3747,37.87029624
E02003611,Central Bedfordshire 013,2341,1287,325,58,2,4013,41.66459008
E02003612,Central Bedfordshire 014,2924,1520,425,71,2,4942,40.83367058
E02003613,Central Bedfordshire 015,1229,808,324,73,2,2436,49.54844007
E02003614,Central Bedfordshire 016,2088,1059,253,44,1,3445,39.3904209
E02003615,Central Bedfordshire 017,2546,1227,332,52,1,4158,38.76863877
E02003616,Bedford 001,1384,756,173,32,0,2345,40.98081023
E02003617,Bedford 002,2139,1236,387,56,6,3824,44.06380753
E02003618,Bedford 003,2009,1219,344,47,3,3622,44.53340696
E02003619,Bedford 004,2740,1431,459,86,2,4718,41.9245443
E02003620,Bedford 005,1837,1156,418,82,12,3505,47.58915835
E02003621,Bedford 006,1708,1154,378,60,4,3304,48.30508475
E02003622,Bedford 007,1616,1379,631,171,13,3810,57.58530184
E02003623,Bedford 008,3272,1383,376,52,0,5083,35.62856581
E02003624,Bedford 009,1228,833,310,72,19,2462,50.12185215
E02003625,Bedford 010,1874,1478,593,222,39,4206,55.44460295
E02003626,Bedford 011,1266,792,237,60,8,2363,46.42403724
E02003627,Bedford 012,2511,1622,694,183,31,5041,50.18845467
E02003628,Bedford 013,1275,1035,560,174,10,3054,58.25147348
E02003629,Bedford 014,1786,1550,737,214,16,4303,58.4940739
E02003630,Bedford 015,1829,1469,731,240,32,4301,57.47500581
E02003631,Bedford 016,1031,759,376,90,11,2267,54.52139391
E02003632,Bedford 017,1206,918,314,80,9,2527,52.27542541
E02003633,Bedford 018,2144,1212,552,119,3,4030,46.79900744
E02003635,Bedford 020,2297,1172,397,77,9,3952,41.87753036
E02003636,Central Bedfordshire 018,1661,993,311,49,0,3014,44.89051095
E02003637,Central Bedfordshire 019,2505,1397,431,77,2,4412,43.22302811
E02003638,Central Bedfordshire 020,1668,1037,298,50,5,3058,45.45454545
E02003639,Central Bedfordshire 021,2072,1503,626,148,6,4355,52.42250287
E02003640,Central Bedfordshire 022,1565,846,228,48,2,2689,41.79992562
E02003641,Central Bedfordshire 023,1361,675,175,13,0,2224,38.80395683
E02003642,Central Bedfordshire 025,1504,1227,605,194,14,3544,57.56207675
E02003643,Central Bedfordshire 024,3220,1602,538,111,8,5479,41.23015149
E02003644,Central Bedfordshire 026,1978,1340,540,145,2,4005,50.61173533
E02003645,Central Bedfordshire 027,1368,979,288,51,2,2688,49.10714286
E02003646,Central Bedfordshire 028,2048,1421,564,115,11,4159,50.7573936
E02003647,Central Bedfordshire 029,2315,1546,599,152,11,4623,49.92429159
E02003648,Central Bedfordshire 030,986,803,379,102,10,2280,56.75438596
E02003649,Central Bedfordshire 031,1513,993,269,44,3,2822,46.38554217
E02003650,Central Bedfordshire 032,1581,1057,334,51,5,3028,47.78731836
E02003651,Central Bedfordshire 033,1608,1004,312,62,3,2989,46.20274339
E02003652,Buckinghamshire 001,2411,1132,330,48,2,3923,38.54193219
E02003653,Buckinghamshire 002,1638,979,274,54,0,2945,44.3803056
E02003654,Buckinghamshire 003,1414,709,215,31,0,2369,40.31236809
E02003655,Buckinghamshire 004,2449,1307,355,60,2,4173,41.31320393
E02003656,Buckinghamshire 005,1635,948,288,54,1,2926,44.12166781
E02003657,Buckinghamshire 006,1817,835,258,41,2,2953,38.4693532
E02003658,Buckinghamshire 007,2449,1187,316,56,1,4009,38.91244699
E02003659,Buckinghamshire 009,2263,1183,310,54,4,3814,40.66596749
E02003660,Buckinghamshire 008,2620,1321,382,45,2,4370,40.04576659
E02003661,Buckinghamshire 010,1360,671,192,22,1,2246,39.44790739
E02003662,Buckinghamshire 012,1296,886,341,93,8,2624,50.6097561
E02003663,Buckinghamshire 011,2905,1439,536,139,6,5025,42.18905473
E02003664,Buckinghamshire 013,1494,1105,452,123,10,3184,53.07788945
E02003665,Buckinghamshire 014,1292,785,265,80,1,2423,46.67767231
E02003666,Buckinghamshire 015,1705,1138,502,143,12,3500,51.28571429
E02003667,Buckinghamshire 016,2297,1239,373,72,9,3990,42.43107769
E02003668,Buckinghamshire 018,1962,1118,378,35,3,3496,43.87871854
E02003669,Buckinghamshire 017,1088,941,521,129,12,2691,59.56893348
E02003670,Buckinghamshire 019,2203,1177,358,77,0,3815,42.2542595
E02003671,Buckinghamshire 020,1196,858,324,73,9,2460,51.38211382
E02003672,Buckinghamshire 021,3008,1456,382,64,1,4911,38.74974547
E02003673,Buckinghamshire 022,2374,1229,302,51,2,3958,40.02021223
E02003674,Buckinghamshire 023,1383,682,186,27,0,2278,39.28884987
E02003675,Buckinghamshire 024,2255,1141,317,46,2,3761,40.04254188
E02003676,Buckinghamshire 029,2011,940,260,39,4,3254,38.19913952
E02003677,Buckinghamshire 027,1961,1299,546,165,14,3985,50.79046424
E02003678,Buckinghamshire 028,1322,759,188,30,3,2302,42.5716768
E02003679,Buckinghamshire 030,1535,1072,399,95,2,3103,50.53174347
E02003680,Buckinghamshire 031,2521,1206,323,42,1,4093,38.4070364
E02003681,Buckinghamshire 032,2618,1218,332,53,1,4222,37.99147324
E02003682,Buckinghamshire 034,1938,864,254,35,1,3092,37.3221216
E02003683,Buckinghamshire 035,1730,815,215,40,3,2803,38.28041384
E02003685,Buckinghamshire 047,2002,924,224,28,1,3179,37.02422145
E02003686,Buckinghamshire 050,1861,921,183,30,1,2996,37.88384513
E02003687,Buckinghamshire 054,1354,652,184,25,2,2217,38.92647722
E02003688,Buckinghamshire 053,3018,1432,357,70,3,4880,38.1557377
E02003689,Buckinghamshire 058,2235,936,168,21,1,3361,33.50193395
E02003690,Buckinghamshire 059,1667,1096,396,59,2,3220,48.22981366
E02003691,Buckinghamshire 063,1713,845,217,46,0,2821,39.27685218
E02003692,Buckinghamshire 064,1909,1092,377,48,2,3428,44.31155193
E02003693,Buckinghamshire 065,1840,893,199,26,1,2959,37.81683001
E02003694,Buckinghamshire 066,1772,1156,440,94,13,3475,49.00719424
E02003695,Buckinghamshire 067,2233,1320,462,107,7,4129,45.91910874
E02003696,Buckinghamshire 026,1995,1270,473,77,0,3815,47.70642202
E02003697,Buckinghamshire 025,1660,699,173,21,0,2553,34.97845672
E02003698,Buckinghamshire 033,2127,975,196,19,0,3317,35.87579138
E02003699,Buckinghamshire 037,1328,764,247,37,2,2378,44.15475189
E02003701,Buckinghamshire 038,2383,1544,551,123,7,4608,48.28559028
E02003702,Buckinghamshire 040,2108,920,187,35,5,3255,35.23809524
E02003703,Buckinghamshire 041,2010,1061,329,96,6,3502,42.60422616
E02003704,Buckinghamshire 045,1487,657,164,22,0,2330,36.18025751
E02003705,Buckinghamshire 042,1234,833,336,88,3,2494,50.521251
E02003706,Buckinghamshire 043,1376,867,347,76,0,2666,48.38709677
E02003707,Buckinghamshire 044,1319,828,342,60,8,2557,48.41611263
E02003708,Buckinghamshire 046,1213,1195,612,177,20,3217,62.29406279
E02003709,Buckinghamshire 048,1065,748,360,88,2,2263,52.93857711
E02003710,Buckinghamshire 049,2349,1451,519,110,6,4435,47.03494927
E02003711,Buckinghamshire 051,2454,1248,448,99,16,4265,42.46189918
E02003712,Buckinghamshire 052,1565,1141,472,99,3,3280,52.28658537
E02003713,Buckinghamshire 055,1340,790,210,36,2,2378,43.65012616
E02003714,Buckinghamshire 056,1700,855,262,64,0,2881,40.99271086
E02003715,Buckinghamshire 057,1710,714,142,12,0,2578,33.66951125
E02003716,Buckinghamshire 060,1522,772,271,44,1,2610,41.68582375
E02003717,Buckinghamshire 062,2365,1126,330,45,2,3868,38.85729059
E02003718,Buckinghamshire 061,1440,691,201,42,6,2380,39.49579832
E02003719,Cambridge 001,1813,1344,647,193,13,4010,54.78802993
E02003720,Cambridge 002,1977,1305,501,118,3,3904,49.35963115
E02003721,Cambridge 003,2067,1296,570,146,5,4084,49.38785504
E02003722,Cambridge 004,2297,1138,279,55,5,3774,39.13619502
E02003723,Cambridge 005,1914,789,193,34,3,2933,34.74258438
E02003724,Cambridge 006,2153,1325,547,196,14,4235,49.16174734
E02003725,Cambridge 007,2233,1051,237,33,7,3561,37.29289525
E02003726,Cambridge 008,2099,954,264,66,1,3384,37.97281324
E02003727,Cambridge 009,2337,1241,378,82,3,4041,42.16778025
E02003728,Cambridge 010,2299,1223,445,110,5,4082,43.67956884
E02003729,Cambridge 011,1997,1178,455,111,6,3747,46.70402989
E02003731,Cambridge 013,2331,1148,413,117,4,4013,41.91378021
E02003732,East Cambridgeshire 001,2012,1371,577,140,1,4101,50.93879542
E02003733,East Cambridgeshire 002,1852,1221,374,60,2,3509,47.22143061
E02003734,East Cambridgeshire 003,2841,1697,525,135,8,5206,45.4283519
E02003735,East Cambridgeshire 004,2121,1198,371,67,5,3762,43.62041467
E02003736,East Cambridgeshire 005,2209,1516,483,93,3,4304,48.67565056
E02003737,East Cambridgeshire 006,2793,1963,720,123,7,5606,50.17838031
E02003738,East Cambridgeshire 007,1459,902,295,47,1,2704,46.04289941
E02003739,East Cambridgeshire 008,1567,871,276,47,1,2762,43.26574946
E02003740,East Cambridgeshire 009,1415,805,256,42,2,2520,43.84920635
E02003742,Fenland 001,1234,1134,522,99,11,3000,58.86666667
E02003743,Fenland 002,1574,1773,886,237,17,4487,64.92088255
E02003744,Fenland 003,2107,2326,1222,328,9,5992,64.8364486
E02003745,Fenland 004,1920,1598,742,184,8,4452,56.87331536
E02003746,Fenland 005,1338,1167,490,105,3,3103,56.88043829
E02003747,Fenland 006,2532,1973,833,180,15,5533,54.23820712
E02003748,Fenland 007,1405,1315,697,124,12,3553,60.45595272
E02003749,Fenland 008,1235,979,322,74,1,2611,52.7001149
E02003750,Fenland 009,1397,1254,565,108,7,3331,58.06064245
E02003751,Fenland 010,1433,1171,454,84,2,3144,54.42111959
E02003752,Fenland 011,2194,1783,708,178,14,4877,55.01332787
E02003753,Huntingdonshire 001,2331,1552,616,126,12,4637,49.73042916
E02003754,Huntingdonshire 002,1373,794,235,39,3,2444,43.82160393
E02003755,Huntingdonshire 003,1802,1360,551,102,4,3819,52.814873
E02003756,Huntingdonshire 004,1605,1022,346,67,4,3044,47.27332457
E02003757,Huntingdonshire 005,1576,975,331,65,4,2951,46.59437479
E02003758,Huntingdonshire 006,2215,1341,366,56,4,3982,44.37468609
E02003759,Huntingdonshire 007,1446,772,234,30,1,2483,41.76399517
E02003760,Huntingdonshire 008,1341,1225,623,204,15,3408,60.65140845
E02003761,Huntingdonshire 009,1233,910,274,51,0,2468,50.04051864
E02003762,Huntingdonshire 010,2725,1522,455,86,4,4792,43.13439065
E02003763,Huntingdonshire 011,2296,1373,424,81,3,4177,45.03231985
E02003764,Huntingdonshire 012,2584,1434,496,130,2,4646,44.38226431
E02003765,Huntingdonshire 013,1719,1125,420,80,3,3347,48.64057365
E02003766,Huntingdonshire 014,1951,1088,346,77,3,3465,43.69408369
E02003767,Huntingdonshire 015,1650,771,209,33,0,2663,38.03980473
E02003768,Huntingdonshire 016,2553,1365,375,53,2,4348,41.28334867
E02003769,Huntingdonshire 017,1556,965,243,46,2,2812,44.66571835
E02003770,Huntingdonshire 018,2627,1308,390,70,2,4397,40.25471913
E02003771,Huntingdonshire 019,1457,1000,415,81,3,2956,50.71041949
E02003772,Huntingdonshire 020,1710,965,243,23,6,2947,41.97488972
E02003773,Huntingdonshire 021,2289,1565,603,136,4,4597,50.20665652
E02003774,Huntingdonshire 022,1166,885,379,64,5,2499,53.34133653
E02003775,South Cambridgeshire 001,1744,919,287,48,3,3001,41.88603799
E02003776,South Cambridgeshire 002,1625,940,305,41,2,2913,44.21558531
E02003777,South Cambridgeshire 003,2477,1158,320,60,1,4016,38.32171315
E02003778,South Cambridgeshire 004,1591,893,256,41,3,2784,42.85201149
E02003780,South Cambridgeshire 006,2619,1480,477,107,6,4689,44.14587332
E02003781,South Cambridgeshire 007,1645,789,229,44,2,2709,39.27648579
E02003784,South Cambridgeshire 010,2217,1047,285,42,2,3593,38.296688
E02003785,South Cambridgeshire 011,2164,1242,369,65,0,3840,43.64583333
E02003786,South Cambridgeshire 012,1731,858,220,40,0,2849,39.24183924
E02003787,South Cambridgeshire 013,1777,1145,338,48,1,3309,46.29797522
E02003788,South Cambridgeshire 014,2142,946,243,36,0,3367,36.38253638
E02003789,South Cambridgeshire 015,1555,1015,400,84,1,3055,49.09983633
E02003790,South Cambridgeshire 016,2292,1228,354,42,2,3918,41.5007657
E02003791,South Cambridgeshire 017,2033,1040,303,40,0,3416,40.48594848
E02003792,South Cambridgeshire 018,2257,1384,428,64,2,4135,45.4171705
E02003793,South Cambridgeshire 019,1612,933,257,65,4,2871,43.85231627
E02004356,Eastbourne 001,1124,1098,563,169,10,2964,62.0782726
E02004357,Eastbourne 002,1130,1071,639,161,16,3017,62.54557507
E02004358,Eastbourne 003,1350,1281,689,198,13,3531,61.76720476
E02004359,Eastbourne 004,1329,1265,646,175,18,3433,61.28750364
E02004361,Eastbourne 006,1661,1140,424,80,8,3313,49.86417145
E02004362,Eastbourne 007,1679,1250,556,118,10,3613,53.52892333
E02004363,Eastbourne 008,1534,1144,445,115,30,3268,53.05997552
E02004364,Eastbourne 009,1887,1318,519,125,18,3867,51.20248254
E02004365,Eastbourne 010,1425,1398,813,322,65,4023,64.57867263
E02004366,Eastbourne 011,1694,1508,662,148,30,4042,58.09005443
E02004367,Eastbourne 012,1616,1278,364,66,7,3331,51.48604023
E02004368,Hastings 001,1645,1170,428,94,13,3350,50.89552239
E02004369,Hastings 002,2074,1594,586,87,1,4342,52.23399355
E02004370,Hastings 003,1035,1078,812,322,18,3265,68.30015314
E02004371,Hastings 004,1243,1063,522,133,8,2969,58.13405187
E02004372,Hastings 005,946,985,689,279,20,2919,67.59164097
E02004373,Hastings 006,1530,1323,617,164,15,3649,58.0707043
E02004374,Hastings 007,1540,1167,487,119,12,3325,53.68421053
E02004375,Hastings 008,1695,1356,642,202,17,3912,56.67177914
E02004376,Hastings 009,1458,1217,667,207,28,3577,59.23958625
E02004377,Hastings 010,2104,1605,639,138,9,4495,53.19243604
E02004378,Hastings 011,1737,1615,910,338,53,4653,62.66924565
E02004379,Lewes 001,1790,996,289,50,1,3126,42.73832374
E02004380,Lewes 002,2309,1250,321,53,3,3936,41.33638211
E02004381,Lewes 003,2162,1460,583,165,18,4388,50.72926162
E02004382,Lewes 004,1380,972,351,78,1,2782,50.39539899
E02004383,Lewes 005,1690,945,300,65,3,3003,43.72294372
E02004384,Lewes 006,1496,1153,434,83,3,3169,52.79267908
E02004385,Lewes 007,1423,1252,583,147,16,3421,58.40397545
E02004386,Lewes 008,1268,1107,470,129,13,2987,57.54938065
E02004387,Lewes 009,945,829,482,133,21,2410,60.78838174
E02004388,Lewes 010,1327,1236,640,158,14,3375,60.68148148
E02004389,Lewes 011,2025,1549,537,61,0,4172,51.46212848
E02004390,Lewes 012,1612,1317,498,108,3,3538,54.43753533
E02004391,Lewes 013,1507,1238,490,138,9,3382,55.44056771
E02004392,Rother 001,2037,1266,390,86,4,3783,46.15384615
E02004393,Rother 002,1335,1030,436,86,4,2891,53.82220685
E02004394,Rother 003,1765,1106,369,60,1,3301,46.53135414
E02004395,Rother 004,1599,1333,562,135,7,3636,56.02310231
E02004396,Rother 005,1956,1469,502,87,2,4016,51.29482072
E02004397,Rother 006,1689,1197,440,64,5,3395,50.25036819
E02004398,Rother 007,1466,1378,824,246,15,3929,62.6877068
E02004399,Rother 008,1553,1405,624,105,2,3689,57.90187043
E02004400,Rother 009,2324,1919,581,52,2,4878,52.35752358
E02004401,Rother 010,1688,1513,537,65,1,3804,55.6256572
E02004402,Rother 011,1839,1859,847,205,25,4775,61.48691099
E02004403,Wealden 001,1534,876,236,31,0,2677,42.69704894
E02004404,Wealden 002,1644,776,183,23,1,2627,37.41910925
E02004405,Wealden 003,1359,837,255,31,5,2487,45.35585042
E02004406,Wealden 004,1774,994,290,39,0,3097,42.71876009
E02004407,Wealden 005,2048,1062,316,39,1,3466,40.91171379
E02004408,Wealden 006,1767,1120,391,72,3,3353,47.30092455
E02004409,Wealden 007,1314,656,161,23,0,2154,38.99721448
E02004410,Wealden 008,1962,1043,274,37,3,3319,40.88580898
E02004411,Wealden 009,1878,1308,433,81,3,3703,49.28436403
E02004412,Wealden 010,1855,1255,378,70,0,3558,47.86396852
E02004413,Wealden 011,1688,1032,327,44,4,3095,45.46042003
E02004414,Wealden 012,1531,885,277,58,3,2754,44.40813362
E02004415,Wealden 013,1561,912,236,38,2,2749,43.21571481
E02004416,Wealden 014,1453,960,295,44,6,2758,47.3168963
E02004417,Wealden 015,1324,1107,406,61,1,2899,54.32907899
E02004418,Wealden 016,1103,896,388,80,8,2475,55.43434343
E02004419,Wealden 017,1030,1012,528,148,12,2730,62.27106227
E02004420,Wealden 018,3141,2023,638,86,3,5891,46.68137837
E02004421,Wealden 019,1946,1522,624,114,2,4208,53.75475285
E02004422,Wealden 020,2298,1737,642,93,1,4771,51.83399707
E02004423,Wealden 021,1618,1377,433,73,0,3501,53.78463296
E02004424,Basildon 001,1718,812,190,14,0,2734,37.16166789
E02004425,Basildon 002,1752,1008,337,58,5,3160,44.55696203
E02004426,Basildon 003,1949,1021,322,56,4,3352,41.85560859
E02004427,Basildon 004,1906,1112,363,53,2,3436,44.52852154
E02004428,Basildon 005,1326,1068,462,97,9,2962,55.23295071
E02004429,Basildon 006,1465,1169,433,58,1,3126,53.1349968
E02004430,Basildon 007,1763,1106,372,56,4,3301,46.59194184
E02004431,Basildon 008,2110,1371,458,91,6,4036,47.72051536
E02004432,Basildon 009,1356,832,328,41,2,2559,47.010551
E02004433,Basildon 010,1673,1249,570,168,7,3667,54.37687483
E02004434,Basildon 011,1464,1265,609,164,12,3514,58.33807627
E02004435,Basildon 012,1573,1400,621,200,21,3815,58.76802097
E02004436,Basildon 013,1006,1099,747,277,18,3147,68.03304735
E02004437,Basildon 014,1970,1396,701,206,9,4282,53.993461
E02004438,Basildon 015,1473,1379,777,231,28,3888,62.11419753
E02004439,Basildon 016,1410,1362,759,254,9,3794,62.83605693
E02004440,Basildon 017,1589,1332,596,121,11,3649,56.45382297
E02004441,Basildon 018,1125,1272,670,204,11,3282,65.72212066
E02004442,Basildon 019,1104,1179,741,252,27,3303,66.57584015
E02004443,Basildon 020,2187,1419,579,140,14,4339,49.59668126
E02004444,Basildon 021,1980,1152,363,69,5,3569,44.52227515
E02004445,Basildon 022,1360,1221,655,201,18,3455,60.63675832
E02004446,Braintree 001,1509,990,331,50,1,2881,47.62235335
E02004447,Braintree 002,1463,849,238,33,4,2587,43.44800928
E02004448,Braintree 003,1694,1144,363,76,2,3279,48.3379079
E02004449,Braintree 004,1706,1429,605,147,14,3901,56.26762369
E02004450,Braintree 005,1478,810,348,36,2,2674,44.72700075
E02004451,Braintree 006,2150,1332,426,71,3,3982,46.00703164
E02004452,Braintree 007,1827,1349,445,58,4,3683,50.39370079
E02004453,Braintree 008,1228,1126,553,177,6,3090,60.25889968
E02004454,Braintree 009,2093,1504,626,150,7,4380,52.21461187
E02004455,Braintree 010,1752,983,300,40,0,3075,43.02439024
E02004456,Braintree 011,1828,1475,668,177,9,4157,56.02598027
E02004457,Braintree 012,2021,1440,556,136,8,4161,51.42994472
E02004458,Braintree 013,2133,1191,384,47,3,3758,43.24108568
E02004459,Braintree 014,2335,1483,536,71,6,4431,47.30309185
E02004460,Braintree 015,1941,1410,539,131,10,4031,51.84817663
E02004461,Braintree 016,922,785,407,121,4,2239,58.82090219
E02004462,Braintree 017,2598,1775,713,179,11,5276,50.75815011
E02004463,Braintree 018,1808,1117,403,69,1,3398,46.79223072
E02004464,Brentwood 001,2001,1340,421,67,3,3832,47.78183716
E02004465,Brentwood 002,1560,846,314,55,3,2778,43.84449244
E02004466,Brentwood 003,1685,1136,429,112,13,3375,50.07407407
E02004467,Brentwood 004,1763,1015,425,102,15,3320,46.89759036
E02004468,Brentwood 005,2586,1264,313,33,3,4199,38.41390807
E02004469,Brentwood 006,1626,932,283,49,1,2891,43.75648565
E02004470,Brentwood 007,3282,1668,602,155,10,5717,42.59226867
E02004471,Brentwood 008,1938,1139,443,120,7,3647,46.86043323
E02004472,Brentwood 009,1494,833,237,23,0,2587,42.24971009
E02004473,Castle Point 001,1477,1176,412,60,0,3125,52.736
E02004474,Castle Point 002,1650,1150,426,77,2,3305,50.07564297
E02004475,Castle Point 003,1259,949,349,81,4,2642,52.34670704
E02004476,Castle Point 004,1722,1075,373,48,3,3221,46.53834213
E02004477,Castle Point 005,1307,943,340,44,2,2636,50.41729894
E02004478,Castle Point 006,1360,1042,469,92,1,2964,54.11605938
E02004479,Castle Point 007,1626,1167,435,82,6,3316,50.96501809
E02004480,Castle Point 008,1206,983,407,87,3,2686,55.10052122
E02004481,Castle Point 009,1062,1322,664,136,7,3191,66.7188969
E02004482,Castle Point 010,1096,1210,639,221,9,3175,65.48031496
E02004483,Castle Point 011,1215,1353,655,157,13,3393,64.19098143
E02004484,Castle Point 012,1408,1392,730,179,26,3735,62.30254351
E02004485,Chelmsford 001,2229,1131,437,81,4,3882,42.58114374
E02004486,Chelmsford 002,2126,1055,312,41,4,3538,39.90955342
E02004487,Chelmsford 003,1477,1046,419,98,11,3051,51.58964274
E02004488,Chelmsford 004,2373,1279,389,70,1,4112,42.29085603
E02004489,Chelmsford 005,2126,1106,340,71,0,3643,41.64150425
E02004490,Chelmsford 006,1241,1188,632,198,13,3272,62.07212714
E02004491,Chelmsford 007,1738,1019,223,31,0,3011,42.27831285
E02004492,Chelmsford 008,2255,1229,380,91,6,3961,43.06993184
E02004493,Chelmsford 009,2297,1316,475,142,7,4237,45.78711352
E02004495,Chelmsford 011,1821,1202,426,78,6,3533,48.45740164
E02004496,Chelmsford 012,1975,933,285,39,5,3237,38.9867161
E02004497,Chelmsford 013,1833,1135,357,40,2,3367,45.55984556
E02004498,Chelmsford 014,2067,1436,584,172,10,4269,51.58116655
E02004499,Chelmsford 015,1524,899,254,20,0,2697,43.49276974
E02004500,Chelmsford 016,2065,1256,342,73,0,3736,44.72698073
E02004501,Chelmsford 017,1489,1020,368,78,2,2957,49.64491038
E02004502,Chelmsford 018,1550,990,332,46,1,2919,46.89962316
E02004503,Chelmsford 019,1788,1116,320,53,2,3279,45.47118024
E02004504,Chelmsford 020,1902,1018,312,80,7,3319,42.6935824
E02004505,Chelmsford 021,1280,967,382,54,3,2686,52.34549516
E02004506,Colchester 001,1656,923,258,40,2,2879,42.48002779
E02004507,Colchester 002,2175,1284,499,161,16,4135,47.40024184
E02004508,Colchester 003,1462,895,249,65,4,2675,45.34579439
E02004512,Colchester 007,2896,1857,638,159,6,5556,47.87616991
E02004513,Colchester 008,1568,1549,892,276,12,4297,63.50942518
E02004514,Colchester 009,1305,790,257,55,4,2411,45.87308171
E02004515,Colchester 010,2256,1198,363,48,2,3867,41.66020171
E02004516,Colchester 011,2791,1836,756,204,19,5606,50.21405637
E02004517,Colchester 012,2111,1289,509,96,6,4011,47.36973323
E02004518,Colchester 013,1997,1029,268,50,3,3347,40.33462803
E02004519,Colchester 014,1572,1091,386,60,2,3111,49.46962392
E02004520,Colchester 015,1710,1119,493,136,8,3466,50.66358915
E02004521,Colchester 016,1922,1445,679,166,16,4228,54.54115421
E02004522,Colchester 017,1856,1172,319,54,4,3405,45.49192364
E02004523,Colchester 018,1813,1520,623,190,8,4154,56.35532017
E02004524,Colchester 019,1814,1111,341,46,0,3312,45.2294686
E02004525,Colchester 020,1681,1302,451,91,12,3537,52.47384789
E02004526,Colchester 021,1638,1222,424,74,5,3363,51.29348796
E02004527,Epping Forest 001,2113,1285,461,94,3,3956,46.58746208
E02004528,Epping Forest 002,1760,1232,429,74,4,3499,49.69991426
E02004529,Epping Forest 003,1513,927,332,65,2,2839,46.70658683
E02004530,Epping Forest 004,1380,1060,409,69,5,2923,52.78823127
E02004531,Epping Forest 005,1540,917,376,84,7,2924,47.33242134
E02004532,Epping Forest 006,1576,879,295,61,6,2817,44.05395811
E02004533,Epping Forest 007,1244,1146,577,134,6,3107,59.96137753
E02004534,Epping Forest 008,1684,1301,550,135,12,3682,54.26398696
E02004535,Epping Forest 009,1137,994,460,122,10,2723,58.24458318
E02004536,Epping Forest 010,1331,862,285,50,2,2530,47.39130435
E02004537,Epping Forest 011,1625,1343,717,290,20,3995,59.32415519
E02004538,Epping Forest 012,2274,1163,333,53,3,3826,40.56455829
E02004539,Epping Forest 013,1576,1057,472,99,9,3213,50.9492686
E02004540,Epping Forest 014,1438,759,206,32,1,2436,40.96880131
E02004541,Epping Forest 015,2871,1457,459,84,6,4877,41.13184335
E02004542,Epping Forest 016,1484,785,232,47,0,2548,41.75824176
E02004543,Epping Forest 017,1339,936,314,72,9,2670,49.85018727
E02004544,Harlow 001,2621,1390,504,113,6,4634,43.43979284
E02004545,Harlow 002,1183,1209,625,176,24,3217,63.22660864
E02004546,Harlow 003,1341,1335,672,189,14,3551,62.23598986
E02004547,Harlow 004,1567,1407,700,210,20,3904,59.86168033
E02004548,Harlow 005,1983,1129,321,46,0,3479,43.00086232
E02004549,Harlow 006,1236,1177,633,143,31,3220,61.61490683
E02004550,Harlow 007,1319,1403,727,252,44,3745,64.77970628
E02004551,Harlow 008,1247,1128,607,180,15,3177,60.7491344
E02004552,Harlow 009,1183,1047,451,91,5,2777,57.40007202
E02004553,Harlow 010,1294,1118,527,138,12,3089,58.10942052
E02004554,Harlow 011,1276,1054,583,131,18,3062,58.32789027
E02004555,Maldon 001,1401,908,277,50,2,2638,46.89158453
E02004556,Maldon 002,1742,961,285,51,3,3042,42.73504274
E02004557,Maldon 003,1817,1281,457,123,4,3682,50.65181966
E02004558,Maldon 004,1529,1156,508,121,5,3319,53.9319072
E02004559,Maldon 005,1740,1120,432,78,2,3372,48.39857651
E02004560,Maldon 006,1669,1336,557,113,3,3678,54.62207722
E02004561,Maldon 007,2051,1538,513,96,4,4202,51.18990957
E02004562,Maldon 008,1893,1388,558,123,6,3968,52.29334677
E02004563,Rochford 001,1226,1161,465,53,4,2909,57.85493297
E02004564,Rochford 002,1592,1186,406,57,3,3244,50.92478422
E02004566,Rochford 004,1018,822,431,129,14,2414,57.82932891
E02004567,Rochford 005,1773,1113,343,34,0,3263,45.66349985
E02004568,Rochford 006,1926,1150,423,81,9,3589,46.33602675
E02004569,Rochford 007,1784,1273,557,115,6,3735,52.2356091
E02004570,Rochford 008,1753,1322,528,85,7,3695,52.55751015
E02004571,Rochford 009,1688,1094,369,30,1,3182,46.95160277
E02004572,Rochford 010,1551,1129,482,84,4,3250,52.27692308
E02004573,Tendring 001,1103,1150,566,215,21,3055,63.89525368
E02004574,Tendring 002,1274,1274,669,170,10,3397,62.49632028
E02004575,Tendring 003,2733,1834,632,119,8,5326,48.68569283
E02004576,Tendring 004,1720,1474,597,106,9,3906,55.96518177
E02004577,Tendring 005,1296,794,288,61,1,2440,46.8852459
E02004578,Tendring 006,1422,1519,673,147,5,3766,62.24110462
E02004579,Tendring 007,1486,1294,546,133,10,3469,57.16344768
E02004580,Tendring 008,2235,2318,1066,157,12,5788,61.38562543
E02004581,Tendring 009,1727,1295,431,75,4,3532,51.10419026
E02004582,Tendring 010,1070,1301,767,161,8,3307,67.64439069
E02004583,Tendring 011,1741,1550,651,128,10,4080,57.32843137
E02004584,Tendring 012,1165,1354,664,100,4,3287,64.55734713
E02004585,Tendring 013,1357,1525,787,172,8,3849,64.74408937
E02004586,Tendring 014,1341,1450,784,197,16,3788,64.59873284
E02004587,Tendring 015,1024,1195,849,302,21,3391,69.80241817
E02004588,Tendring 016,950,1236,912,329,62,3489,72.77156778
E02004589,Tendring 017,1128,1225,702,197,11,3263,65.43058535
E02004590,Tendring 018,1086,1633,1170,403,28,4320,74.86111111
E02004591,Uttlesford 001,1965,878,217,33,1,3094,36.48998061
E02004592,Uttlesford 002,3163,1893,642,109,6,5813,45.58747635
E02004593,Uttlesford 003,2239,1095,303,28,4,3669,38.9751976
E02004594,Uttlesford 004,1886,1025,314,63,3,3291,42.69219082
E02004595,Uttlesford 005,3543,1770,543,90,3,5949,40.44377206
E02004596,Uttlesford 006,2253,1228,426,101,4,4012,43.84346959
E02004597,Uttlesford 007,2163,1207,404,77,3,3854,43.87649196
E02004598,Uttlesford 008,2553,1262,368,66,2,4251,39.9435427
E02004599,Uttlesford 009,1686,1007,292,49,1,3035,44.44810544
E02004675,Basingstoke and Deane 001,1644,1141,376,54,2,3217,48.89648741
E02004676,Basingstoke and Deane 002,1908,1138,305,49,1,3401,43.89885328
E02004677,Basingstoke and Deane 003,1811,826,232,42,1,2912,37.80906593
E02004678,Basingstoke and Deane 004,1840,1052,286,48,1,3227,42.98109699
E02004679,Basingstoke and Deane 005,2786,1280,356,57,1,4480,37.8125
E02004680,Basingstoke and Deane 006,2197,896,211,16,0,3320,33.8253012
E02004681,Basingstoke and Deane 007,2959,1836,774,202,10,5781,48.8150839
E02004682,Basingstoke and Deane 008,1904,1012,392,77,4,3389,43.81823547
E02004683,Basingstoke and Deane 009,1665,1166,485,102,3,3421,51.33002046
E02004684,Basingstoke and Deane 010,2543,1426,501,115,7,4592,44.62108014
E02004685,Basingstoke and Deane 011,1893,1337,459,88,6,3783,49.96034893
E02004686,Basingstoke and Deane 012,1997,1285,459,111,6,3858,48.23742872
E02004687,Basingstoke and Deane 013,1298,1024,444,105,8,2879,54.91490101
E02004688,Basingstoke and Deane 014,1374,1204,628,190,16,3412,59.73036342
E02004689,Basingstoke and Deane 015,1392,786,177,25,0,2380,41.51260504
E02004690,Basingstoke and Deane 016,1842,1117,336,42,4,3341,44.86680635
E02004691,Basingstoke and Deane 017,2003,993,299,45,2,3342,40.06582885
E02004692,Basingstoke and Deane 018,1651,1024,306,36,1,3018,45.29489728
E02004693,Basingstoke and Deane 019,1501,1094,443,139,11,3188,52.91718946
E02004694,Basingstoke and Deane 020,1865,988,291,43,2,3189,41.51771715
E02004695,Basingstoke and Deane 021,2220,908,177,23,0,3328,33.29326923
E02004696,Basingstoke and Deane 022,1891,991,263,39,3,3187,40.66520238
E02004697,East Hampshire 001,1708,750,173,38,1,2670,36.02996255
E02004698,East Hampshire 002,1287,1038,479,155,17,2976,56.75403226
E02004699,East Hampshire 003,2663,1539,425,80,1,4708,43.43670348
E02004700,East Hampshire 004,1551,819,298,80,6,2754,43.68191721
E02004702,East Hampshire 006,1706,1111,420,82,4,3323,48.66084863
E02004703,East Hampshire 007,3143,1464,369,49,0,5025,37.45273632
E02004704,East Hampshire 008,1476,823,244,46,3,2592,43.05555556
E02004705,East Hampshire 009,2314,1307,360,72,4,4057,42.96278038
E02004706,East Hampshire 010,1834,957,264,56,0,3111,41.04789457
E02004707,East Hampshire 011,2861,1383,341,58,4,4647,38.43339789
E02004708,East Hampshire 012,2274,1444,530,102,11,4361,47.85599633
E02004709,East Hampshire 013,2073,1123,338,48,3,3585,42.17573222
E02004710,East Hampshire 014,1499,880,276,45,3,2703,44.54310026
E02004712,Eastleigh 001,2171,993,223,26,2,3415,36.42752562
E02004713,Eastleigh 002,1822,1089,311,43,4,3269,44.26430101
E02004714,Eastleigh 003,1925,1070,291,49,1,3336,42.29616307
E02004715,Eastleigh 004,2002,1275,479,110,10,3876,48.34881321
E02004716,Eastleigh 005,1885,1219,417,81,2,3604,47.69700333
E02004717,Eastleigh 006,2567,1695,754,201,8,5225,50.8708134
E02004718,Eastleigh 007,1850,1319,533,131,5,3838,51.79781136
E02004719,Eastleigh 008,2751,1478,345,43,1,4618,40.42875704
E02004720,Eastleigh 009,2674,1738,535,87,2,5036,46.90230342
E02004721,Eastleigh 010,2960,1172,277,43,1,4453,33.52795868
E02004722,Eastleigh 011,1502,1041,430,83,3,3059,50.8989866
E02004723,Eastleigh 012,2357,1302,373,47,1,4080,42.23039216
E02004724,Eastleigh 013,2176,1246,465,85,6,3978,45.2991453
E02004725,Eastleigh 014,1169,849,335,84,7,2444,52.1685761
E02004726,Eastleigh 015,1588,808,266,39,1,2702,41.22871947
E02004727,Fareham 001,2496,1056,269,37,1,3859,35.3200311
E02004728,Fareham 002,2144,1197,410,51,2,3804,43.6382755
E02004729,Fareham 003,1430,1058,469,106,8,3071,53.43536307
E02004730,Fareham 004,2096,1170,296,36,1,3599,41.76160044
E02004731,Fareham 005,1873,1086,271,39,1,3270,42.72171254
E02004732,Fareham 006,2234,1101,337,43,0,3715,39.8654105
E02004733,Fareham 007,1984,1050,315,77,2,3428,42.12368728
E02004734,Fareham 008,2415,1505,494,70,10,4494,46.26168224
E02004735,Fareham 009,1791,1124,311,35,1,3262,45.09503372
E02004736,Fareham 010,1888,1240,354,40,3,3525,46.43971631
E02004737,Fareham 011,1489,1181,558,136,14,3378,55.92066311
E02004738,Fareham 012,1562,1107,419,77,3,3168,50.69444444
E02004739,Fareham 013,1448,1093,357,30,1,2929,50.5633322
E02004740,Fareham 014,1714,1097,302,22,0,3135,45.32695375
E02004741,Gosport 001,1287,1184,557,117,4,3149,59.1298825
E02004742,Gosport 002,1224,1192,600,127,4,3147,61.10581506
E02004743,Gosport 003,1571,1074,389,63,4,3101,49.33892293
E02004744,Gosport 004,1712,1306,611,156,12,3797,54.91177245
E02004745,Gosport 005,1700,1369,550,173,16,3808,55.35714286
E02004746,Gosport 006,2506,1724,555,79,0,4864,48.47861842
E02004747,Gosport 007,1261,1018,460,107,12,2858,55.87823653
E02004748,Gosport 008,1901,1722,869,286,18,4796,60.36280234
E02004749,Gosport 009,1633,1056,318,38,2,3047,46.40630128
E02004750,Gosport 010,1728,1168,397,61,0,3354,48.47942755
E02004751,Hart 001,1919,1164,361,80,8,3532,45.66817667
E02004752,Hart 002,1985,950,240,19,1,3195,37.87167449
E02004753,Hart 003,2377,1423,427,73,0,4300,44.72093023
E02004754,Hart 004,1855,914,259,56,2,3086,39.88982502
E02004755,Hart 005,3294,1431,370,56,2,5153,36.07607219
E02004756,Hart 006,2463,1112,268,37,1,3881,36.53697501
E02004757,Hart 007,1945,964,237,21,0,3167,38.58541206
E02004758,Hart 008,2240,1079,335,70,5,3729,39.93027621
E02004759,Hart 009,1961,1042,276,32,2,3313,40.8089345
E02004760,Hart 010,2628,1106,291,32,0,4057,35.22307123
E02004761,Hart 011,1583,712,199,51,1,2546,37.82403771
E02004764,Havant 003,1638,1367,529,107,18,3659,55.2336704
E02004765,Havant 004,1520,908,248,31,2,2709,43.89073459
E02004766,Havant 005,1223,1104,513,131,8,2979,58.94595502
E02004767,Havant 006,787,831,466,170,10,2264,65.2385159
E02004768,Havant 007,1036,772,346,82,13,2249,53.93508226
E02004769,Havant 008,809,929,547,188,14,2487,67.47084841
E02004770,Havant 009,939,1022,627,218,12,2818,66.67849539
E02004771,Havant 010,1255,1313,804,270,17,3659,65.70101121
E02004772,Havant 011,2018,1361,489,104,20,3992,49.4488978
E02004774,Havant 013,2583,1537,479,77,0,4676,44.76047904
E02004775,Havant 014,2482,1508,496,122,8,4616,46.2305026
E02004776,Havant 015,1338,938,301,54,4,2635,49.22201139
E02004777,Havant 016,1092,990,410,89,16,2597,57.95148248
E02004778,Havant 017,1277,1161,431,81,7,2957,56.81433886
E02004779,New Forest 001,2644,1611,513,91,4,4863,45.63026938
E02004780,New Forest 002,1121,877,397,92,16,2503,55.21374351
E02004781,New Forest 003,1825,1100,319,82,8,3334,45.26094781
E02004782,New Forest 004,1515,1236,573,121,9,3454,56.13781123
E02004783,New Forest 005,1609,1005,311,58,6,2989,46.16928739
E02004784,New Forest 006,1294,743,224,19,2,2282,43.29535495
E02004785,New Forest 007,1361,768,238,33,4,2404,43.38602329
E02004786,New Forest 008,1911,1123,402,72,9,3517,45.66391811
E02004787,New Forest 009,1799,1199,408,41,4,3451,47.87018256
E02004788,New Forest 010,1572,980,293,50,2,2897,45.73696928
E02004789,New Forest 011,2107,1525,601,135,10,4378,51.87300137
E02004790,New Forest 012,1798,1239,556,96,4,3693,51.31329542
E02004791,New Forest 013,943,780,393,101,12,2229,57.6940332
E02004792,New Forest 014,1857,1378,425,84,4,3748,50.45357524
E02004793,New Forest 015,1820,987,261,30,1,3099,41.27137786
E02004794,New Forest 016,1653,924,259,40,3,2879,42.58423064
E02004795,New Forest 017,2334,1288,373,75,2,4072,42.68172888
E02004796,New Forest 018,2200,1596,458,55,2,4311,48.9677569
E02004797,New Forest 019,1872,1175,517,98,7,3669,48.97792314
E02004798,New Forest 020,1105,936,483,141,10,2675,58.69158879
E02004799,New Forest 021,1687,1467,580,94,4,3832,55.97599165
E02004800,New Forest 022,1776,1364,371,31,2,3544,49.88713318
E02004801,New Forest 023,2104,1294,313,33,2,3746,43.83342232
E02004802,Rushmoor 001,1095,924,417,100,10,2546,56.99135899
E02004803,Rushmoor 002,1015,958,508,157,14,2652,61.72699849
E02004804,Rushmoor 003,1555,924,291,44,1,2815,44.76021314
E02004805,Rushmoor 004,2155,1051,254,42,2,3504,38.49885845
E02004806,Rushmoor 005,1881,975,273,51,1,3181,40.86765168
E02004807,Rushmoor 006,1951,1327,538,104,7,3927,50.31830914
E02004808,Rushmoor 007,2772,1485,544,116,12,4929,43.76141205
E02004809,Rushmoor 008,2045,1231,532,161,14,3983,48.65679136
E02004810,Rushmoor 009,1599,1057,440,109,5,3210,50.18691589
E02004811,Rushmoor 010,1574,1208,493,141,8,3424,54.03037383
E02004812,Rushmoor 011,1436,829,260,42,1,2568,44.08099688
E02004813,Rushmoor 012,1003,920,485,145,8,2561,60.83561109
E02004814,Test Valley 001,1787,873,258,29,1,2948,39.38263229
E02004815,Test Valley 002,1096,1092,512,152,10,2862,61.70510133
E02004817,Test Valley 004,1576,1175,456,104,4,3315,52.45852187
E02004818,Test Valley 005,2277,1393,425,61,2,4158,45.23809524
E02004819,Test Valley 006,1860,1105,361,49,1,3376,44.90521327
E02004820,Test Valley 007,1727,891,289,38,0,2945,41.3582343
E02004821,Test Valley 008,1350,657,175,22,0,2204,38.7477314
E02004822,Test Valley 009,1984,1061,289,51,6,3391,41.4921852
E02004823,Test Valley 010,2179,1257,359,62,5,3862,43.57845676
E02004824,Test Valley 011,1433,1152,377,80,2,3044,52.92378449
E02004825,Test Valley 012,2564,1480,484,90,6,4624,44.55017301
E02004826,Test Valley 013,2434,1142,278,65,6,3925,37.98726115
E02004827,Test Valley 014,1888,782,137,20,1,2828,33.23903819
E02004828,Test Valley 015,1708,935,261,23,1,2928,41.66666667
E02004829,Winchester 001,1511,709,161,16,1,2398,36.98915763
E02004830,Winchester 002,1718,785,252,32,2,2789,38.40086052
E02004831,Winchester 003,2376,1167,307,44,3,3897,39.03002309
E02004832,Winchester 004,2156,1195,356,46,2,3755,42.58322237
E02004833,Winchester 005,2134,1041,358,66,8,3607,40.83726088
E02004834,Winchester 006,1464,1178,538,156,9,3345,56.23318386
E02004835,Winchester 007,2888,1295,373,93,5,4654,37.94585303
E02004836,Winchester 008,896,851,396,78,8,2229,59.80260206
E02004837,Winchester 009,2145,926,241,27,1,3340,35.77844311
E02004838,Winchester 010,2413,1171,335,45,2,3966,39.15784165
E02004839,Winchester 011,2294,1045,284,40,0,3663,37.37373737
E02004840,Winchester 012,2537,1420,450,75,3,4485,43.43366778
E02004841,Winchester 013,2989,1470,398,67,4,4928,39.34659091
E02004842,Winchester 014,2632,1453,458,108,6,4657,43.48292892
E02004843,Broxbourne 001,1415,930,306,46,2,2699,47.57317525
E02004844,Broxbourne 002,1365,971,439,103,6,2884,52.66990291
E02004845,Broxbourne 003,1597,1333,546,139,19,3634,56.05393506
E02004846,Broxbourne 004,1452,761,216,30,1,2460,40.97560976
E02004847,Broxbourne 005,1968,1482,626,163,13,4252,53.7158984
E02004848,Broxbourne 006,1466,964,383,108,10,2931,49.98294098
E02004849,Broxbourne 007,1473,822,238,38,2,2573,42.75165177
E02004850,Broxbourne 008,1356,1082,489,119,10,3056,55.62827225
E02004851,Broxbourne 009,1020,906,409,88,7,2430,58.02469136
E02004852,Broxbourne 010,1509,1196,482,106,12,3305,54.3419062
E02004853,Broxbourne 011,1163,980,475,139,22,2779,58.15041382
E02004854,Broxbourne 012,1424,1206,535,106,7,3278,56.55887736
E02004855,Broxbourne 013,1318,1339,669,220,25,3571,63.09157099
E02004856,Dacorum 001,1396,717,205,45,0,2363,40.92255607
E02004857,Dacorum 002,1555,721,209,40,0,2525,38.41584158
E02004858,Dacorum 003,1136,643,250,45,1,2075,45.25301205
E02004859,Dacorum 004,1402,668,141,28,0,2239,37.38276016
E02004860,Dacorum 005,1238,834,290,65,4,2431,49.07445496
E02004861,Dacorum 006,1393,757,217,27,2,2396,41.86143573
E02004862,Dacorum 007,1255,1171,516,143,14,3099,59.50306551
E02004863,Dacorum 008,1236,1106,615,189,16,3162,60.91081594
E02004864,Dacorum 009,1886,809,188,8,3,2894,34.83068417
E02004865,Dacorum 010,1216,789,303,90,15,2413,49.60629921
E02004866,Dacorum 011,1270,925,447,96,6,2744,53.71720117
E02004867,Dacorum 012,1556,742,225,41,5,2569,39.43168548
E02004868,Dacorum 013,1514,996,418,129,8,3065,50.60358891
E02004869,Dacorum 014,1516,652,166,33,1,2368,35.97972973
E02004870,Dacorum 015,2451,1676,688,186,27,5028,51.25298329
E02004871,Dacorum 016,1068,655,246,69,3,2041,47.67270946
E02004872,Dacorum 017,1532,966,346,77,6,2927,47.65971985
E02004873,Dacorum 018,3164,1426,419,84,10,5103,37.99725652
E02004874,Dacorum 019,1165,832,323,74,4,2398,51.41784821
E02004875,Dacorum 020,2008,1278,524,137,10,3957,49.25448572
E02004876,Dacorum 021,1994,1132,312,33,2,3473,42.58566081
E02004877,Dacorum 022,1245,662,193,34,2,2136,41.71348315
E02004878,East Hertfordshire 001,2065,1170,396,60,3,3694,44.09853817
E02004880,East Hertfordshire 003,2627,1173,339,56,2,4197,37.40767215
E02004881,East Hertfordshire 004,1741,913,286,47,2,2989,41.75309468
E02004882,East Hertfordshire 005,1819,1036,287,55,5,3202,43.19175515
E02004883,East Hertfordshire 006,1389,854,238,42,1,2524,44.96830428
E02004884,East Hertfordshire 007,2412,1424,590,104,3,4533,46.79020516
E02004885,East Hertfordshire 008,2008,951,260,26,0,3245,38.1201849
E02004886,East Hertfordshire 009,1441,784,294,48,2,2569,43.90813546
E02004887,East Hertfordshire 010,1789,995,256,44,1,3085,42.00972447
E02004888,East Hertfordshire 011,2012,1189,392,58,4,3655,44.95212038
E02004889,East Hertfordshire 012,2519,1541,540,114,6,4720,46.63135593
E02004890,East Hertfordshire 013,2268,1138,346,51,2,3805,40.39421813
E02004891,East Hertfordshire 014,1988,1018,321,58,1,3386,41.28765505
E02004892,East Hertfordshire 015,1289,814,329,94,3,2529,49.03123764
E02004893,East Hertfordshire 016,1448,679,215,31,1,2374,39.00589722
E02004894,East Hertfordshire 017,2735,1314,404,76,1,4530,39.62472406
E02004895,East Hertfordshire 018,2001,1184,406,96,2,3689,45.7576579
E02004896,Hertsmere 001,1818,1144,368,45,7,3382,46.24482555
E02004897,Hertsmere 002,1372,912,283,39,3,2609,47.41280184
E02004898,Hertsmere 003,1403,1135,504,133,12,3187,55.97740822
E02004899,Hertsmere 004,1195,629,214,58,5,2101,43.1223227
E02004900,Hertsmere 005,2000,915,245,25,4,3189,37.28441518
E02004901,Hertsmere 006,1763,1386,668,238,17,4072,56.7043222
E02004902,Hertsmere 007,1360,1104,458,126,8,3056,55.4973822
E02004903,Hertsmere 008,1545,897,352,82,2,2878,46.31688673
E02004904,Hertsmere 009,1354,976,420,103,12,2865,52.7399651
E02004905,Hertsmere 010,1408,752,228,29,1,2418,41.7700579
E02004906,Hertsmere 011,2161,1379,531,131,4,4206,48.62101759
E02004907,Hertsmere 012,2450,1432,449,79,4,4414,44.49478931
E02004908,Hertsmere 013,2312,1487,452,59,1,4311,46.3697518
E02004909,North Hertfordshire 001,1352,796,330,51,1,2530,46.56126482
E02004910,North Hertfordshire 002,2852,1599,439,62,5,4957,42.46520073
E02004911,North Hertfordshire 003,1324,1095,488,125,6,3038,56.41869651
E02004912,North Hertfordshire 004,2564,1505,512,90,9,4680,45.21367521
E02004914,North Hertfordshire 006,1794,1083,488,99,7,3471,48.31460674
E02004915,North Hertfordshire 007,1142,843,369,110,6,2470,53.76518219
E02004916,North Hertfordshire 008,1675,1027,320,60,3,3085,45.70502431
E02004917,North Hertfordshire 009,1254,944,394,96,6,2694,53.45211581
E02004918,North Hertfordshire 010,2190,1035,372,75,5,3677,40.44057656
E02004919,North Hertfordshire 011,1801,961,355,88,6,3211,43.91155403
E02004920,North Hertfordshire 012,2708,1614,605,110,7,5044,46.31245044
E02004921,North Hertfordshire 013,2039,968,248,49,6,3310,38.39879154
E02004922,North Hertfordshire 014,2346,1302,419,90,2,4159,43.59220967
E02004923,North Hertfordshire 015,2595,1355,398,75,11,4434,41.47496617
E02004924,St Albans 001,1873,780,190,25,0,2868,34.69316597
E02004925,St Albans 002,1827,780,257,73,1,2938,37.81484003
E02004926,St Albans 003,2249,873,145,24,3,3294,31.7243473
E02004927,St Albans 004,1590,788,237,34,2,2651,40.02263297
E02004928,St Albans 005,1781,707,150,15,0,2653,32.86845081
E02004929,St Albans 006,1520,760,242,53,1,2576,40.99378882
E02004930,St Albans 007,1669,856,258,47,3,2833,41.08718673
E02004931,St Albans 008,1577,863,232,46,1,2719,42.00073556
E02004932,St Albans 009,1632,852,357,104,10,2955,44.7715736
E02004933,St Albans 010,1768,627,114,20,2,2531,30.14618728
E02004934,St Albans 011,2144,857,233,53,5,3292,34.87241798
E02004935,St Albans 012,2918,1055,300,91,7,4371,33.24182109
E02004936,St Albans 013,1563,693,144,27,0,2427,35.59950556
E02004937,St Albans 014,1996,836,156,13,0,3001,33.48883705
E02004939,St Albans 016,1383,892,335,83,1,2694,48.6636971
E02004940,St Albans 017,1620,920,359,94,6,2999,45.981994
E02004941,St Albans 018,2020,1284,475,109,7,3895,48.13863928
E02004942,St Albans 019,1453,849,269,50,3,2624,44.62652439
E02004943,St Albans 020,1867,1079,302,51,4,3303,43.47562822
E02004944,Stevenage 001,1547,1000,418,126,13,3104,50.16108247
E02004945,Stevenage 002,2648,1570,514,121,1,4854,45.44705398
E02004946,Stevenage 003,1182,879,431,120,15,2627,55.00570994
E02004948,Stevenage 005,1213,914,443,96,7,2673,54.62027684
E02004949,Stevenage 006,1705,1362,652,164,12,3895,56.22593068
E02004950,Stevenage 007,1248,957,374,83,4,2666,53.18829707
E02004951,Stevenage 008,1427,1208,587,173,26,3421,58.28705057
E02004952,Stevenage 009,1293,935,418,108,10,2764,53.21997106
E02004953,Stevenage 010,1108,835,421,115,15,2494,55.5733761
E02004954,Stevenage 011,1349,972,466,117,9,2913,53.69035359
E02004955,Stevenage 012,1174,815,343,76,5,2413,51.34687111
E02004956,Three Rivers 001,2100,1284,402,70,3,3859,45.58175693
E02004957,Three Rivers 002,2295,1305,473,118,13,4204,45.40913416
E02004958,Three Rivers 003,1852,907,269,43,3,3074,39.75276513
E02004959,Three Rivers 004,1564,688,152,15,3,2422,35.42526837
E02004960,Three Rivers 005,1412,598,155,21,3,2189,35.49566012
E02004961,Three Rivers 006,2250,1161,321,39,1,3772,40.34994698
E02004962,Three Rivers 007,2136,1074,378,70,5,3663,41.68714169
E02004963,Three Rivers 008,1311,969,400,90,14,2784,52.90948276
E02004964,Three Rivers 009,1144,772,324,76,4,2320,50.68965517
E02004965,Three Rivers 010,1312,989,388,60,2,2751,52.30825154
E02004966,Three Rivers 011,1746,706,127,16,0,2595,32.71676301
E02004967,Three Rivers 012,1272,1131,594,196,30,3223,60.53366429
E02004968,Watford 001,1446,992,440,136,8,3022,52.15089345
E02004969,Watford 002,1501,927,322,68,2,2820,46.77304965
E02004970,Watford 003,1441,1133,536,149,11,3270,55.93272171
E02004971,Watford 004,1505,1085,403,93,6,3092,51.32600259
E02004972,Watford 005,1354,753,251,39,2,2399,43.55981659
E02004973,Watford 006,1750,1134,404,114,11,3413,48.72546147
E02004974,Watford 007,2120,1064,337,60,11,3592,40.97995546
E02004975,Watford 008,1729,896,264,49,1,2939,41.17046614
E02004976,Watford 009,2335,1840,758,198,18,5149,54.65138862
E02004977,Watford 010,1534,1100,417,103,8,3162,51.48640101
E02004978,Watford 011,1691,1315,648,174,20,3848,56.05509356
E02004979,Watford 012,1645,876,311,82,7,2921,43.68366998
E02004980,Welwyn Hatfield 001,1509,735,171,14,1,2430,37.90123457
E02004981,Welwyn Hatfield 002,1867,983,318,61,3,3232,42.23391089
E02004982,Welwyn Hatfield 003,1302,795,249,50,1,2397,45.68210263
E02004983,Welwyn Hatfield 004,1221,895,403,81,4,2604,53.11059908
E02004984,Welwyn Hatfield 005,1435,953,404,88,15,2895,50.43177893
E02004985,Welwyn Hatfield 006,1633,1017,366,73,7,3096,47.25452196
E02004986,Welwyn Hatfield 007,1882,1156,530,162,4,3734,49.59828602
E02004987,Welwyn Hatfield 008,1582,1006,375,74,3,3040,47.96052632
E02004988,Welwyn Hatfield 009,1555,1029,402,120,7,3113,50.04818503
E02004989,Welwyn Hatfield 010,2009,1378,492,100,8,3987,49.61123652
E02004990,Welwyn Hatfield 011,1498,985,344,83,5,2915,48.61063465
E02004991,Welwyn Hatfield 012,1329,1109,533,120,4,3095,57.05977383
E02004992,Welwyn Hatfield 013,1214,1085,429,103,9,2840,57.25352113
E02004994,Welwyn Hatfield 015,1462,688,159,25,1,2335,37.3875803
E02004995,Welwyn Hatfield 016,1246,744,189,20,1,2200,43.36363636
E02004996,Ashford 001,1895,1131,381,82,4,3493,45.74864014
E02004997,Ashford 002,1768,1135,423,104,4,3434,48.51485149
E02004998,Ashford 003,1385,957,321,46,4,2713,48.9495024
E02005000,Ashford 005,2305,1646,790,199,22,4962,53.54695687
E02005001,Ashford 006,1932,1241,501,111,5,3790,49.0237467
E02005002,Ashford 007,1696,1492,708,169,13,4078,58.41098578
E02005003,Ashford 008,1329,1166,613,173,5,3286,59.55569081
E02005004,Ashford 009,2359,1448,546,117,8,4478,47.32023225
E02005005,Ashford 010,2357,1305,398,59,3,4122,42.81901989
E02005006,Ashford 011,1284,899,270,46,3,2502,48.68105516
E02005007,Ashford 012,1999,1273,452,79,11,3814,47.58783429
E02005008,Ashford 013,2048,1417,548,88,4,4105,50.10962241
E02005009,Ashford 014,1223,898,327,53,7,2508,51.23604466
E02005010,Canterbury 001,1429,1368,640,212,23,3672,61.083878
E02005011,Canterbury 002,1489,1284,488,74,3,3338,55.39245057
E02005012,Canterbury 003,1567,1370,679,174,14,3804,58.80651945
E02005013,Canterbury 004,1414,1391,708,148,5,3666,61.42935079
E02005014,Canterbury 005,1878,1358,457,36,2,3731,49.66496918
E02005015,Canterbury 006,1900,1330,505,86,6,3827,50.35275673
E02005016,Canterbury 007,1683,1148,497,90,7,3425,50.86131387
E02005017,Canterbury 008,1718,1037,340,69,3,3167,45.75307862
E02005018,Canterbury 009,1789,1310,510,91,8,3708,51.75296656
E02005019,Canterbury 010,1285,886,307,61,9,2548,49.56828885
E02005020,Canterbury 011,1337,1111,507,123,6,3084,56.64721141
E02005021,Canterbury 012,1434,921,273,39,2,2669,46.27201199
E02005022,Canterbury 013,1284,1093,442,133,10,2962,56.65091155
E02005023,Canterbury 014,1325,1196,720,291,25,3557,62.74950801
E02005025,Canterbury 016,1954,1181,415,65,14,3629,46.15596583
E02005026,Canterbury 017,1745,1022,360,72,4,3203,45.51982516
E02005027,Canterbury 018,1258,744,229,42,0,2273,44.65464144
E02005028,Dartford 001,2802,1535,733,215,22,5307,47.20180893
E02005029,Dartford 002,3762,1539,522,97,12,5932,36.58125421
E02005030,Dartford 003,2684,1539,574,119,4,4920,45.44715447
E02005031,Dartford 004,1550,1081,525,157,15,3328,53.42548077
E02005032,Dartford 005,2001,1306,535,110,11,3963,49.50794852
E02005033,Dartford 006,1396,1132,474,141,13,3156,55.76679341
E02005034,Dartford 007,1585,960,244,32,1,2822,43.83416017
E02005035,Dartford 008,1636,1073,376,47,4,3136,47.83163265
E02005036,Dartford 009,1032,915,485,159,8,2599,60.29242016
E02005037,Dartford 010,1446,982,318,33,0,2779,47.96689457
E02005038,Dartford 011,1246,762,295,47,2,2352,47.02380952
E02005039,Dartford 012,1242,942,390,91,6,2671,53.50056159
E02005040,Dartford 013,1463,915,314,35,3,2730,46.41025641
E02005041,Dover 001,1583,978,368,75,4,3008,47.37367021
E02005042,Dover 002,1927,1413,582,90,4,4016,52.01693227
E02005043,Dover 003,1471,1226,521,109,6,3333,55.86558656
E02005044,Dover 004,1609,1094,434,81,4,3222,50.06207325
E02005045,Dover 005,1765,1293,680,149,7,3894,54.67385722
E02005046,Dover 006,1568,1159,575,147,5,3454,54.60335843
E02005047,Dover 007,1429,1245,604,148,14,3440,58.45930233
E02005048,Dover 008,1410,948,324,62,5,2749,48.70862132
E02005049,Dover 009,1618,1163,350,55,2,3188,49.24717691
E02005050,Dover 010,2054,1412,492,65,7,4030,49.03225806
E02005051,Dover 011,2128,1937,1135,375,18,5593,61.95244055
E02005052,Dover 012,1412,1359,715,213,26,3725,62.09395973
E02005053,Dover 013,1435,1410,791,294,23,3953,63.69845687
E02005054,Dover 014,1408,1042,431,55,1,2937,52.05992509
E02005055,Gravesham 001,1226,1155,606,200,22,3209,61.7949517
E02005056,Gravesham 002,1674,1726,890,312,49,4651,64.00774027
E02005057,Gravesham 003,1974,1554,667,157,10,4362,54.74552957
E02005058,Gravesham 004,1245,1078,506,123,9,2961,57.95339412
E02005059,Gravesham 005,1973,1278,446,74,7,3778,47.77660138
E02005060,Gravesham 006,1621,1074,541,103,7,3346,51.55409444
E02005061,Gravesham 007,1069,980,578,181,13,2821,62.1056363
E02005062,Gravesham 008,1194,974,362,59,1,2590,53.8996139
E02005063,Gravesham 009,1332,887,369,87,2,2677,50.24280911
E02005064,Gravesham 010,1382,914,315,50,1,2662,48.08414726
E02005065,Gravesham 011,1219,1154,575,198,18,3164,61.47281922
E02005066,Gravesham 012,1677,1132,330,42,4,3185,47.34693878
E02005067,Gravesham 013,1248,833,196,41,0,2318,46.16048318
E02005068,Maidstone 001,1733,842,205,43,1,2824,38.63314448
E02005069,Maidstone 002,1988,1212,342,51,2,3595,44.70097357
E02005070,Maidstone 003,2167,1411,423,45,2,4048,46.4673913
E02005071,Maidstone 004,2510,1830,824,283,30,5477,54.17199197
E02005072,Maidstone 005,1893,977,281,25,0,3176,40.39672544
E02005073,Maidstone 006,2734,1770,690,176,26,5396,49.33283914
E02005074,Maidstone 007,1916,1081,324,53,1,3375,43.22962963
E02005075,Maidstone 008,2234,1292,549,135,12,4222,47.08668877
E02005076,Maidstone 009,1836,1357,544,156,14,3907,53.00742257
E02005077,Maidstone 010,1347,1140,496,113,12,3108,56.66023166
E02005078,Maidstone 011,2076,1382,435,88,4,3985,47.90464241
E02005079,Maidstone 012,1951,1202,356,53,2,3564,45.25813692
E02005080,Maidstone 013,1739,1704,1010,299,23,4775,63.58115183
E02005081,Maidstone 014,1504,1062,372,59,2,2999,49.84994998
E02005082,Maidstone 015,2492,1557,511,96,6,4662,46.54654655
E02005083,Maidstone 016,1697,1084,386,64,3,3234,47.52628324
E02005084,Maidstone 017,1657,1022,315,60,6,3060,45.8496732
E02005085,Maidstone 018,1728,982,334,89,6,3139,44.95062122
E02005086,Maidstone 019,1503,857,250,49,5,2664,43.58108108
E02005087,Sevenoaks 001,1440,1005,353,63,1,2862,49.68553459
E02005088,Sevenoaks 002,1407,1454,840,308,21,4030,65.08684864
E02005089,Sevenoaks 003,1452,992,315,55,2,2816,48.4375
E02005090,Sevenoaks 004,1220,871,285,48,3,2427,49.73217965
E02005091,Sevenoaks 005,1589,930,326,58,2,2905,45.30120482
E02005093,Sevenoaks 007,1170,964,370,74,2,2580,54.65116279
E02005094,Sevenoaks 008,2381,1247,367,61,5,4061,41.36912091
E02005095,Sevenoaks 009,1726,955,262,35,1,2979,42.06109433
E02005096,Sevenoaks 010,2261,1200,448,112,8,4029,43.88185654
E02005097,Sevenoaks 011,2353,879,187,27,3,3449,31.77732676
E02005098,Sevenoaks 012,2567,1123,312,63,4,4069,36.9132465
E02005099,Sevenoaks 013,1982,1000,302,63,3,3350,40.8358209
E02005100,Sevenoaks 014,2209,1318,509,125,3,4164,46.95004803
E02005101,Sevenoaks 015,1727,809,247,49,1,2833,39.03988705
E02005102,Folkestone and Hythe 001,1378,964,298,59,4,2703,49.01960784
E02005103,Folkestone and Hythe 002,1904,1337,509,125,6,3881,50.94047926
E02005104,Folkestone and Hythe 003,1286,1174,676,202,17,3355,61.66915052
E02005105,Folkestone and Hythe 004,1252,1106,643,191,18,3210,60.99688474
E02005106,Folkestone and Hythe 005,1786,1402,641,182,10,4021,55.58318826
E02005107,Folkestone and Hythe 006,2778,1834,665,117,6,5400,48.55555556
E02005109,Folkestone and Hythe 008,1675,989,286,27,0,2977,43.735304
E02005110,Folkestone and Hythe 009,1477,1061,430,61,2,3031,51.27020785
E02005111,Folkestone and Hythe 010,1494,1355,661,159,18,3687,59.47925142
E02005112,Folkestone and Hythe 011,1241,1165,571,136,5,3118,60.19884541
E02005113,Folkestone and Hythe 012,1379,1209,497,86,4,3175,56.56692913
E02005114,Folkestone and Hythe 013,1002,1129,474,127,4,2736,63.37719298
E02005115,Swale 001,827,1006,549,220,17,2619,68.42306224
E02005116,Swale 002,701,947,668,297,17,2630,73.3460076
E02005117,Swale 003,1143,1107,424,106,1,2781,58.89967638
E02005118,Swale 004,1924,1521,707,164,4,4320,55.46296296
E02005119,Swale 005,1059,955,515,132,8,2669,60.32221806
E02005120,Swale 006,1080,1172,712,210,16,3190,66.14420063
E02005121,Swale 007,2617,1764,644,184,14,5223,49.89469653
E02005122,Swale 008,1590,1018,396,90,7,3101,48.72621735
E02005123,Swale 009,2469,1647,624,135,21,4896,49.57107843
E02005124,Swale 010,1295,1396,825,268,16,3800,65.92105263
E02005125,Swale 011,1468,1194,535,179,4,3380,56.56804734
E02005126,Swale 012,1571,1159,469,93,7,3299,52.37950894
E02005127,Swale 013,1916,1155,345,69,6,3491,45.1160126
E02005128,Swale 014,1764,1311,517,129,6,3727,52.66970754
E02005129,Swale 015,2357,1757,763,206,11,5094,53.72987829
E02005130,Swale 016,1819,1357,545,135,8,3864,52.92443064
E02005131,Swale 017,1209,833,303,58,8,2411,49.85483202
E02005132,Thanet 001,1550,1733,1132,468,70,4953,68.70583485
E02005133,Thanet 002,1805,1466,500,73,3,3847,53.08032233
E02005134,Thanet 003,1351,1211,694,256,26,3538,61.81458451
E02005135,Thanet 004,1287,1104,627,166,11,3195,59.71830986
E02005136,Thanet 005,1433,1155,551,120,3,3262,56.06989577
E02005137,Thanet 006,1023,1106,705,250,21,3105,67.0531401
E02005138,Thanet 007,1716,1530,740,176,14,4176,58.90804598
E02005139,Thanet 008,1784,1677,712,109,5,4287,58.38581759
E02005140,Thanet 009,1682,1295,387,67,7,3438,51.0762071
E02005141,Thanet 010,1539,1182,410,87,15,3233,52.39715435
E02005142,Thanet 011,1256,1182,628,118,3,3187,60.58989645
E02005143,Thanet 012,1537,1289,548,120,7,3501,56.09825764
E02005144,Thanet 013,1115,1253,841,306,21,3536,68.46719457
E02005145,Thanet 014,1647,1205,522,91,7,3472,52.56336406
E02005146,Thanet 015,1538,1131,508,129,7,3313,53.57681859
E02005147,Thanet 016,1759,1616,929,306,34,4644,62.12316968
E02005148,Thanet 017,1574,1348,520,69,2,3513,55.19499004
E02005149,Tonbridge and Malling 001,2730,1588,531,94,2,4945,44.79271992
E02005150,Tonbridge and Malling 002,2404,1638,701,188,6,4937,51.30646141
E02005151,Tonbridge and Malling 003,2675,1700,621,148,4,5148,48.03807304
E02005153,Tonbridge and Malling 005,1906,1249,546,105,4,3810,49.97375328
E02005154,Tonbridge and Malling 006,2721,1399,448,64,3,4635,41.29449838
E02005155,Tonbridge and Malling 007,2955,1342,302,62,4,4665,36.65594855
E02005156,Tonbridge and Malling 008,1404,1038,406,87,4,2939,52.2286492
E02005157,Tonbridge and Malling 009,1152,971,490,121,10,2744,58.01749271
E02005158,Tonbridge and Malling 010,1532,791,217,46,2,2588,40.80370943
E02005159,Tonbridge and Malling 011,1525,1134,399,75,4,3137,51.38667517
E02005160,Tonbridge and Malling 012,2911,1704,619,130,8,5372,45.81161579
E02005161,Tonbridge and Malling 013,2028,1030,379,63,4,3504,42.12328767
E02005162,Tunbridge Wells 001,2237,1439,535,116,5,4332,48.36103416
E02005163,Tunbridge Wells 002,1790,911,340,79,6,3126,42.73832374
E02005164,Tunbridge Wells 003,1995,1175,416,133,22,3741,46.67201283
E02005165,Tunbridge Wells 004,1658,1027,322,77,7,3091,46.36040116
E02005166,Tunbridge Wells 005,1173,945,520,156,7,2801,58.12209925
E02005167,Tunbridge Wells 006,1790,890,220,39,3,2942,39.15703603
E02005168,Tunbridge Wells 007,2005,898,230,52,4,3189,37.12762622
E02005169,Tunbridge Wells 008,2515,1429,550,131,11,4636,45.75064711
E02005170,Tunbridge Wells 009,2452,1222,375,76,10,4135,40.70133011
E02005171,Tunbridge Wells 010,1190,914,466,110,8,2688,55.72916667
E02005172,Tunbridge Wells 011,1939,967,308,55,4,3273,40.75771463
E02005173,Tunbridge Wells 012,2383,1013,257,39,3,3695,35.50744249
E02005174,Tunbridge Wells 013,1660,979,365,66,7,3077,46.05134872
E02005175,Tunbridge Wells 014,1857,1178,393,59,6,3493,46.8365302
E02005503,Breckland 001,1573,1091,382,71,4,3121,49.59948734
E02005504,Breckland 002,1867,1511,529,84,3,3994,53.25488232
E02005505,Breckland 003,1448,1182,471,115,8,3224,55.08684864
E02005506,Breckland 004,1376,1102,473,56,3,3010,54.28571429
E02005507,Breckland 005,2263,1957,856,194,12,5282,57.15638016
E02005508,Breckland 006,1534,1073,381,66,3,3057,49.82008505
E02005509,Breckland 007,1673,1493,668,131,4,3969,57.84832451
E02005510,Breckland 008,1431,1248,506,80,6,3271,56.25191073
E02005511,Breckland 009,1602,1607,666,122,5,4002,59.97001499
E02005512,Breckland 010,1897,1289,479,79,3,3747,49.3728316
E02005513,Breckland 011,2210,1658,660,145,5,4678,52.75758871
E02005514,Breckland 012,1338,1239,386,74,4,3041,56.00131536
E02005515,Breckland 013,1351,939,331,47,3,2671,49.419693
E02005516,Breckland 014,1536,1097,307,61,1,3002,48.83411059
E02005517,Breckland 015,842,864,488,144,7,2345,64.09381663
E02005518,Breckland 016,2226,1652,535,115,4,4532,50.88261253
E02005519,Breckland 017,1286,1258,666,190,10,3410,62.28739003
E02005520,Broadland 001,2004,1427,549,94,3,4077,50.84621045
E02005521,Broadland 002,1910,1339,469,79,4,3801,49.75006577
E02005522,Broadland 003,1230,781,303,47,3,2364,47.96954315
E02005523,Broadland 004,1833,1207,398,74,4,3516,47.8668942
E02005524,Broadland 005,1150,887,292,47,0,2376,51.5993266
E02005525,Broadland 006,2292,1380,432,67,2,4173,45.07548526
E02005526,Broadland 007,1185,821,261,41,1,2309,48.67908185
E02005527,Broadland 008,2120,1195,427,69,2,3813,44.40073433
E02005528,Broadland 009,1970,1313,450,70,3,3806,48.23962165
E02005529,Broadland 010,1142,965,434,73,3,2617,56.36224685
E02005530,Broadland 011,1172,845,324,49,1,2391,50.98285236
E02005531,Broadland 012,1175,790,332,69,2,2368,50.38006757
E02005532,Broadland 013,2219,1540,526,72,2,4359,49.09382886
E02005533,Broadland 014,1974,1327,527,86,3,3917,49.604289
E02005534,Broadland 015,1630,1211,459,95,4,3399,52.04471904
E02005535,Broadland 016,1809,942,258,44,3,3056,40.80497382
E02005536,Broadland 017,1429,951,299,40,0,2719,47.4439132
E02005537,Broadland 018,1206,1046,393,54,2,2701,55.34987042
E02005538,Great Yarmouth 001,1830,1646,703,164,1,4344,57.87292818
E02005539,Great Yarmouth 002,1538,1244,538,94,1,3415,54.96339678
E02005540,Great Yarmouth 003,1648,1623,753,140,2,4166,60.44167067
E02005541,Great Yarmouth 004,868,991,519,162,9,2549,65.94743036
E02005542,Great Yarmouth 005,1020,1237,786,319,35,3397,69.97350603
E02005543,Great Yarmouth 006,1042,1525,1076,465,46,4154,74.91574386
E02005544,Great Yarmouth 007,1060,1103,682,252,16,3113,65.9492451
E02005545,Great Yarmouth 008,1308,1037,427,68,3,2843,53.9922617
E02005546,Great Yarmouth 009,1250,1342,788,318,44,3742,66.59540353
E02005547,Great Yarmouth 010,1701,1380,607,115,4,3807,55.31914894
E02005548,Great Yarmouth 011,1077,1097,718,196,7,3095,65.20193861
E02005549,Great Yarmouth 012,1038,955,403,85,5,2486,58.2461786
E02005550,Great Yarmouth 013,1615,1197,526,92,3,3433,52.95659773
E02005551,King's Lynn and West Norfolk 001,1097,1087,425,87,6,2702,59.40044412
E02005552,King's Lynn and West Norfolk 002,1491,1157,406,70,6,3130,52.36421725
E02005553,King's Lynn and West Norfolk 003,1776,1679,676,120,4,4255,58.26086957
E02005554,King's Lynn and West Norfolk 004,1435,1290,520,84,2,3331,56.91984389
E02005555,King's Lynn and West Norfolk 005,1592,944,278,28,1,2843,44.00281393
E02005556,King's Lynn and West Norfolk 006,1666,1143,439,75,4,3327,49.92485723
E02005557,King's Lynn and West Norfolk 007,895,1078,572,193,10,2748,67.43085881
E02005558,King's Lynn and West Norfolk 008,1280,1122,529,112,8,3051,58.04654212
E02005559,King's Lynn and West Norfolk 009,1266,1105,506,178,10,3065,58.6949429
E02005560,King's Lynn and West Norfolk 010,1658,1264,563,170,13,3668,54.79825518
E02005561,King's Lynn and West Norfolk 011,2021,1916,1005,278,38,5258,61.56333207
E02005562,King's Lynn and West Norfolk 012,1521,1186,492,108,3,3310,54.04833837
E02005563,King's Lynn and West Norfolk 013,1423,1181,536,112,4,3256,56.2960688
E02005564,King's Lynn and West Norfolk 014,1931,1316,501,78,2,3828,49.55590387
E02005565,King's Lynn and West Norfolk 015,1413,1138,464,102,7,3124,54.76952625
E02005566,King's Lynn and West Norfolk 016,1812,1637,730,172,6,4357,58.4117512
E02005567,King's Lynn and West Norfolk 017,2272,2013,858,142,7,5292,57.06727135
E02005568,King's Lynn and West Norfolk 018,1502,1237,477,113,4,3333,54.93549355
E02005569,King's Lynn and West Norfolk 019,1613,1320,548,107,6,3594,55.11964385
E02005570,North Norfolk 001,1549,1311,482,70,5,3417,54.66783728
E02005571,North Norfolk 002,1332,1058,344,93,3,2830,52.93286219
E02005572,North Norfolk 003,1526,1525,641,156,10,3858,60.44582685
E02005573,North Norfolk 004,1267,1087,448,66,3,2871,55.86903518
E02005574,North Norfolk 005,1477,1242,439,78,7,3243,54.45575085
E02005575,North Norfolk 006,1583,1141,399,52,2,3177,50.17311929
E02005576,North Norfolk 007,1293,1190,549,120,6,3158,59.05636479
E02005577,North Norfolk 008,1346,968,344,60,4,2722,50.55106539
E02005578,North Norfolk 009,1238,957,385,73,1,2654,53.35342879
E02005580,North Norfolk 011,1604,1425,594,142,6,3771,57.46486343
E02005581,North Norfolk 012,1553,1155,460,62,4,3234,51.97897341
E02005582,North Norfolk 013,1344,1252,528,122,7,3253,58.68429142
E02005583,North Norfolk 014,1752,1600,581,111,7,4051,56.7514194
E02005584,Norwich 001,2059,1785,832,258,23,4957,58.46277991
E02005585,Norwich 002,1831,1750,953,311,19,4864,62.35608553
E02005586,Norwich 003,2628,1621,623,199,11,5082,48.28807556
E02005587,Norwich 004,1600,1532,848,273,33,4286,62.66915539
E02005588,Norwich 005,1907,1867,959,271,14,5018,61.99681148
E02005589,Norwich 006,1941,1799,909,278,16,4943,60.73234878
E02005592,Norwich 009,2445,1384,307,50,4,4190,41.64677804
E02005593,Norwich 010,1114,1062,554,150,13,2893,61.49325959
E02005594,Norwich 011,2860,1824,715,201,16,5616,49.07407407
E02005595,Norwich 012,2202,1421,426,72,3,4124,46.60523763
E02005596,Norwich 013,1843,1642,803,256,9,4553,59.52119482
E02005598,South Norfolk 002,2442,1289,297,70,1,4099,40.42449378
E02005599,South Norfolk 003,1698,980,357,67,1,3103,45.27876249
E02005600,South Norfolk 004,1248,874,309,38,0,2469,49.45321993
E02005601,South Norfolk 005,1220,1020,436,78,5,2759,55.7810801
E02005602,South Norfolk 006,3196,1820,512,78,4,5610,43.03030303
E02005603,South Norfolk 007,2994,1650,530,98,3,5275,43.24170616
E02005604,South Norfolk 008,1935,1296,468,102,12,3813,49.25255704
E02005605,South Norfolk 009,2483,1478,463,73,5,4502,44.84673478
E02005606,South Norfolk 010,1268,880,291,49,7,2495,49.17835671
E02005607,South Norfolk 011,2491,1711,539,96,5,4842,48.5543164
E02005608,South Norfolk 012,1605,1202,452,67,1,3327,51.75834085
E02005609,South Norfolk 013,1589,1337,467,86,0,3479,54.32595573
E02005610,South Norfolk 014,1727,1291,442,66,4,3530,51.07648725
E02005611,South Norfolk 015,2253,1960,743,137,6,5099,55.81486566
E02005921,Cherwell 001,1792,847,269,52,6,2966,39.58192852
E02005922,Cherwell 002,2002,1135,383,102,6,3628,44.81808159
E02005923,Cherwell 003,976,866,374,115,7,2338,58.25491873
E02005924,Cherwell 004,2686,1916,797,216,16,5631,52.29976914
E02005925,Cherwell 005,1152,1208,667,222,20,3269,64.7598654
E02005926,Cherwell 006,1899,1356,512,101,4,3872,50.95557851
E02005927,Cherwell 007,1302,825,258,45,6,2436,46.55172414
E02005928,Cherwell 008,2691,1303,325,58,1,4378,38.53357698
E02005929,Cherwell 009,1878,967,240,37,0,3122,39.8462524
E02005930,Cherwell 010,2335,1157,307,49,2,3850,39.35064935
E02005931,Cherwell 011,2682,1300,320,40,4,4346,38.28808099
E02005932,Cherwell 012,1638,795,225,22,1,2681,38.90339426
E02005933,Cherwell 013,1545,1105,371,78,5,3104,50.22551546
E02005934,Cherwell 014,1667,1267,488,100,1,3523,52.68237298
E02005935,Cherwell 015,2178,1167,360,66,4,3775,42.30463576
E02005936,Cherwell 016,2982,1449,386,77,3,4897,39.10557484
E02005937,Cherwell 017,1526,1008,332,62,4,2932,47.95361528
E02005938,Cherwell 018,1161,796,251,41,3,2252,48.44582593
E02005939,Cherwell 019,1564,987,297,48,2,2898,46.03174603
E02005940,Oxford 001,1526,762,251,57,6,2602,41.35280553
E02005941,Oxford 002,1705,779,215,47,3,2749,37.97744634
E02005942,Oxford 003,1561,604,101,18,1,2285,31.68490153
E02005943,Oxford 004,1430,891,269,45,3,2638,45.79226687
E02005944,Oxford 005,1407,1058,489,148,12,3114,54.81695568
E02005945,Oxford 006,2256,1199,305,81,0,3841,41.2652955
E02005946,Oxford 007,1981,1023,324,57,8,3393,41.61508989
E02005947,Oxford 008,1455,738,220,60,4,2477,41.25958821
E02005948,Oxford 009,1614,821,234,56,8,2733,40.94401756
E02005949,Oxford 010,1103,843,401,108,5,2460,55.16260163
E02005950,Oxford 011,1986,1295,468,99,10,3858,48.52255054
E02005951,Oxford 012,1361,725,272,53,10,2421,43.78356051
E02005953,Oxford 014,1191,762,254,60,1,2268,47.48677249
E02005954,Oxford 015,1916,1320,502,105,19,3862,50.38839979
E02005955,Oxford 016,1794,1441,668,200,17,4120,56.45631068
E02005956,Oxford 017,836,883,499,163,16,2397,65.1230705
E02005957,Oxford 018,1038,875,502,170,11,2596,60.01540832
E02005958,South Oxfordshire 001,1348,770,189,27,0,2334,42.24507284
E02005959,South Oxfordshire 002,1334,806,234,36,2,2412,44.69320066
E02005960,South Oxfordshire 003,1871,980,356,49,6,3262,42.64255058
E02005961,South Oxfordshire 004,1704,890,242,39,3,2878,40.79221682
E02005962,South Oxfordshire 005,2475,1240,351,48,1,4115,39.85419198
E02005963,South Oxfordshire 006,1694,1172,373,71,3,3313,48.86809538
E02005964,South Oxfordshire 007,1794,967,243,40,2,3046,41.10308601
E02005965,South Oxfordshire 008,1380,726,205,26,1,2338,40.97519247
E02005966,South Oxfordshire 009,2168,933,198,33,0,3332,34.93397359
E02005967,South Oxfordshire 010,2134,1144,392,63,4,3737,42.89537062
E02005968,South Oxfordshire 011,1829,825,194,29,1,2878,36.44892286
E02005969,South Oxfordshire 012,2363,1321,417,93,1,4195,43.67103695
E02005970,South Oxfordshire 013,1170,814,350,95,6,2435,51.95071869
E02005971,South Oxfordshire 014,1295,902,324,73,5,2599,50.17314352
E02005972,South Oxfordshire 015,3059,1362,354,59,3,4837,36.75832127
E02005973,South Oxfordshire 016,1592,900,234,55,2,2783,42.79554438
E02005974,South Oxfordshire 017,1746,810,202,40,4,2802,37.68736617
E02005975,South Oxfordshire 018,2020,1019,206,27,2,3274,38.30177153
E02005976,South Oxfordshire 019,1603,676,139,23,1,2442,34.35708436
E02005977,South Oxfordshire 020,1496,752,210,31,0,2489,39.89554038
E02005978,Vale of White Horse 001,1873,919,234,26,1,3053,38.6505077
E02005979,Vale of White Horse 002,2424,1279,343,57,4,4107,40.97881665
E02005980,Vale of White Horse 003,2456,1276,390,62,2,4186,41.32823698
E02005981,Vale of White Horse 004,2215,1078,208,31,4,3536,37.35859729
E02005982,Vale of White Horse 005,1418,760,210,35,0,2423,41.47750722
E02005983,Vale of White Horse 006,2830,1561,518,145,11,5065,44.12635735
E02005984,Vale of White Horse 007,2356,1091,238,39,1,3725,36.75167785
E02005985,Vale of White Horse 008,1647,1155,466,120,5,3393,51.45888594
E02005986,Vale of White Horse 009,2313,1364,463,88,3,4231,45.3320728
E02005987,Vale of White Horse 010,2302,1363,434,72,0,4171,44.80939823
E02005988,Vale of White Horse 011,2228,1178,344,61,6,3817,41.629552
E02005991,Vale of White Horse 014,2474,1432,486,69,6,4467,44.61607343
E02005992,Vale of White Horse 015,3381,1746,478,76,2,5683,40.50677459
E02005993,West Oxfordshire 001,1736,1089,347,74,5,3251,46.60104583
E02005994,West Oxfordshire 002,1465,824,229,39,3,2560,42.7734375
E02005995,West Oxfordshire 003,1626,829,219,51,3,2728,40.39589443
E02005996,West Oxfordshire 004,2434,1119,294,36,2,3885,37.34877735
E02005997,West Oxfordshire 005,1464,833,271,52,1,2621,44.1434567
E02005998,West Oxfordshire 006,1779,852,258,31,2,2922,39.11704312
E02005999,West Oxfordshire 007,1540,871,271,36,1,2719,43.36152997
E02006000,West Oxfordshire 008,2846,1604,429,95,1,4975,42.79396985
E02006001,West Oxfordshire 009,1674,941,276,58,0,2949,43.23499491
E02006002,West Oxfordshire 010,2459,1656,623,133,8,4879,49.60032794
E02006003,West Oxfordshire 011,1360,844,282,52,1,2539,46.43560457
E02006004,West Oxfordshire 012,1533,836,236,38,3,2646,42.06349206
E02006005,West Oxfordshire 013,2350,1143,330,48,2,3873,39.32352182
E02006006,West Oxfordshire 014,1192,863,295,53,0,2403,50.39533916
E02006007,West Oxfordshire 015,1708,971,297,47,7,3030,43.63036304
E02006227,Babergh 001,1567,1011,346,70,0,2994,47.66199065
E02006228,Babergh 002,1397,906,282,57,1,2643,47.14339765
E02006229,Babergh 003,1380,1006,343,76,1,2806,50.81967213
E02006230,Babergh 004,2361,1626,579,96,4,4666,49.39991427
E02006231,Babergh 005,2098,1242,358,68,2,3768,44.32059448
E02006232,Babergh 006,1337,921,298,48,2,2606,48.6953185
E02006233,Babergh 007,2417,2014,788,232,15,5466,55.78119283
E02006234,Babergh 008,1903,1458,556,128,6,4051,53.02394471
E02006235,Babergh 009,1987,1176,324,51,4,3542,43.90175042
E02006236,Babergh 010,2418,1506,443,52,1,4420,45.29411765
E02006237,Babergh 011,1710,1110,361,55,1,3237,47.17330862
E02006238,West Suffolk 002,1743,1822,757,171,6,4499,61.25805735
E02006239,West Suffolk 001,1528,1392,356,47,4,3327,54.0727382
E02006240,West Suffolk 003,2054,1650,447,72,4,4227,51.4076177
E02006241,West Suffolk 004,1570,1700,640,132,6,4048,61.21541502
E02006242,West Suffolk 007,2581,1541,354,63,3,4542,43.17481286
E02006243,West Suffolk 008,2294,1511,506,109,2,4422,48.12302126
E02006245,Ipswich 001,1252,1250,593,161,6,3262,61.61863887
E02006246,Ipswich 002,1559,1053,386,62,3,3063,49.1021874
E02006247,Ipswich 003,1642,1403,620,182,10,3857,57.42805289
E02006248,Ipswich 004,1670,1091,483,114,3,3361,50.31240702
E02006249,Ipswich 005,2042,1150,382,81,7,3662,44.23812125
E02006250,Ipswich 006,1848,1622,778,245,22,4515,59.06976744
E02006251,Ipswich 007,2525,1700,719,227,28,5199,51.43296788
E02006252,Ipswich 008,2228,1320,496,111,7,4162,46.46804421
E02006253,Ipswich 009,1651,1108,375,50,0,3184,48.14698492
E02006254,Ipswich 010,1605,1423,714,251,17,4010,59.97506234
E02006255,Ipswich 011,1813,1163,451,102,3,3532,48.66930917
E02006256,Ipswich 012,1799,1489,768,230,13,4299,58.15305885
E02006257,Ipswich 013,1110,1062,602,181,3,2958,62.47464503
E02006258,Ipswich 014,1602,1284,675,174,14,3749,57.26860496
E02006259,Ipswich 015,1199,1179,620,157,16,3171,62.18858404
E02006260,Ipswich 016,1351,1306,670,193,5,3525,61.67375887
E02006261,Mid Suffolk 001,1783,1192,382,74,5,3436,48.10826542
E02006262,Mid Suffolk 002,1972,1355,453,66,2,3848,48.75259875
E02006263,Mid Suffolk 003,1627,1218,374,66,4,3289,50.53207662
E02006264,Mid Suffolk 004,2145,1220,352,43,1,3761,42.96729593
E02006265,Mid Suffolk 005,1670,1095,425,71,3,3264,48.83578431
E02006266,Mid Suffolk 006,2129,1415,517,93,2,4156,48.77285852
E02006267,Mid Suffolk 007,1931,1176,355,39,1,3502,44.86007995
E02006268,Mid Suffolk 008,1041,1000,576,148,9,2774,62.47296323
E02006269,Mid Suffolk 009,1798,1033,332,61,6,3230,44.33436533
E02006270,Mid Suffolk 010,3096,1887,492,102,3,5580,44.51612903
E02006271,Mid Suffolk 011,2296,1353,446,71,4,4170,44.94004796
E02006272,Mid Suffolk 012,1646,1175,443,66,1,3331,50.58540979
E02006273,West Suffolk 005,1451,1152,366,82,1,3052,52.45740498
E02006274,West Suffolk 006,1418,898,281,51,5,2653,46.55107426
E02006275,West Suffolk 009,1191,1045,547,133,10,2926,59.29596719
E02006276,West Suffolk 016,1944,1161,367,51,2,3525,44.85106383
E02006277,West Suffolk 012,2016,979,237,41,1,3274,38.42394624
E02006278,West Suffolk 011,2335,1535,510,126,15,4521,48.35213448
E02006279,West Suffolk 014,1888,1461,585,128,6,4068,53.58898722
E02006280,West Suffolk 010,2155,1387,428,59,0,4029,46.51278233
E02006281,West Suffolk 013,2035,1412,496,94,1,4038,49.60376424
E02006282,West Suffolk 017,1574,1046,331,53,0,3004,47.60319574
E02006283,West Suffolk 018,1581,1015,272,42,1,2911,45.68876675
E02006284,West Suffolk 019,1505,1165,503,98,12,3283,54.15778252
E02006285,West Suffolk 021,1549,998,370,92,14,3023,48.75951042
E02006286,West Suffolk 020,2042,1630,733,165,3,4573,55.34659961
E02006287,East Suffolk 016,1524,1048,278,50,0,2900,47.44827586
E02006288,East Suffolk 017,2350,1473,423,50,5,4301,45.36154383
E02006289,East Suffolk 018,2130,1536,629,145,8,4448,52.11330935
E02006290,East Suffolk 019,1829,1425,570,112,6,3942,53.60223237
E02006291,East Suffolk 020,1946,1166,397,83,2,3594,45.85420145
E02006292,East Suffolk 021,1605,925,255,49,2,2836,43.40620592
E02006293,East Suffolk 023,2302,1477,466,80,4,4329,46.82374682
E02006294,East Suffolk 022,1917,1388,429,86,5,3825,49.88235294
E02006295,East Suffolk 024,2069,1389,460,73,2,3993,48.18432256
E02006296,East Suffolk 025,3033,1791,558,82,1,5465,44.50137237
E02006297,East Suffolk 026,1929,1100,296,26,0,3351,42.435094
E02006298,East Suffolk 027,1986,1413,522,112,7,4040,50.84158416
E02006299,East Suffolk 028,1915,1499,404,63,1,3882,50.66975786
E02006300,East Suffolk 029,1443,1383,740,203,11,3780,61.82539683
E02006301,East Suffolk 030,1310,1151,455,91,10,3017,56.57938349
E02006302,East Suffolk 001,1428,1069,425,78,3,3003,52.44755245
E02006303,East Suffolk 002,1155,1154,732,269,17,3327,65.28403968
E02006304,East Suffolk 003,1638,1298,618,113,6,3673,55.40430166
E02006305,East Suffolk 004,1571,1571,877,315,34,4368,64.03388278
E02006306,East Suffolk 005,1342,1212,602,156,12,3324,59.62695548
E02006307,East Suffolk 007,1631,1157,393,53,0,3234,49.56709957
E02006308,East Suffolk 006,1301,1325,837,341,43,3847,66.18144008
E02006309,East Suffolk 009,1048,1145,656,167,6,3022,65.32097948
E02006310,East Suffolk 008,1630,1241,468,99,4,3442,52.64381174
E02006311,East Suffolk 010,1716,1379,636,167,10,3908,56.09007165
E02006312,East Suffolk 011,1821,1354,482,83,2,3742,51.33618386
E02006313,East Suffolk 012,2016,1698,756,150,5,4625,56.41081081
E02006314,East Suffolk 013,1543,1222,466,91,5,3327,53.62188157
E02006315,East Suffolk 014,1314,1051,371,68,5,2809,53.22178711
E02006316,East Suffolk 015,1482,1256,530,123,5,3396,56.36042403
E02006317,Elmbridge 001,1472,800,226,37,1,2536,41.95583596
E02006318,Elmbridge 002,1976,757,158,33,4,2928,32.5136612
E02006319,Elmbridge 003,1430,969,411,92,6,2908,50.82530949
E02006320,Elmbridge 004,1555,971,416,121,5,3068,49.31551499
E02006321,Elmbridge 005,1694,628,148,18,2,2490,31.96787149
E02006322,Elmbridge 006,1606,702,182,33,2,2525,36.3960396
E02006323,Elmbridge 007,1999,1001,332,51,5,3388,40.99763872
E02006324,Elmbridge 008,1770,838,257,58,5,2928,39.54918033
E02006325,Elmbridge 009,2258,856,201,17,1,3333,32.25322532
E02006326,Elmbridge 010,1984,848,239,49,3,3123,36.47134166
E02006327,Elmbridge 011,1846,718,209,25,3,2801,34.09496608
E02006328,Elmbridge 012,2570,1208,336,68,2,4184,38.57552581
E02006329,Elmbridge 013,1791,748,216,35,4,2794,35.89835361
E02006330,Elmbridge 014,2288,1210,441,77,6,4022,43.11287916
E02006331,Elmbridge 015,1813,773,183,37,0,2806,35.38845331
E02006332,Elmbridge 016,1839,638,129,19,1,2626,29.96953542
E02006333,Elmbridge 017,2255,1148,410,83,5,3901,42.19430915
E02006334,Elmbridge 018,2243,812,150,25,0,3230,30.55727554
E02006335,Epsom and Ewell 001,1720,1011,344,46,6,3127,44.99520307
E02006336,Epsom and Ewell 002,1382,912,350,87,3,2734,49.45135333
E02006337,Epsom and Ewell 003,1994,1017,271,23,2,3307,39.70365891
E02006338,Epsom and Ewell 004,1523,779,246,25,4,2577,40.90027163
E02006339,Epsom and Ewell 005,2316,1182,395,115,9,4017,42.34503361
E02006341,Epsom and Ewell 007,2273,1245,468,117,8,4111,44.70931647
E02006342,Epsom and Ewell 008,2023,1190,384,81,22,3700,45.32432432
E02006343,Epsom and Ewell 009,2071,949,251,41,2,3314,37.50754375
E02006344,Guildford 001,2067,1061,278,59,8,3473,40.48373164
E02006345,Guildford 002,1394,809,205,38,3,2449,43.07880768
E02006346,Guildford 003,2504,1118,249,28,1,3900,35.79487179
E02006347,Guildford 004,1765,997,262,47,7,3078,42.65756985
E02006348,Guildford 005,1882,1136,378,57,2,3455,45.52821997
E02006349,Guildford 006,1814,944,301,57,8,3124,41.93341869
E02006350,Guildford 007,1040,862,431,116,7,2456,57.65472313
E02006351,Guildford 008,2046,947,323,70,3,3389,39.62820891
E02006352,Guildford 009,1224,805,224,35,1,2289,46.52686763
E02006353,Guildford 010,1250,861,378,103,8,2600,51.92307692
E02006354,Guildford 011,2472,1110,197,33,4,3816,35.22012579
E02006355,Guildford 012,971,837,435,116,5,2364,58.92554992
E02006356,Guildford 013,3201,1569,471,105,13,5359,40.26870685
E02006357,Guildford 014,1733,931,292,61,2,3019,42.59688639
E02006358,Guildford 015,1596,819,285,44,9,2753,42.02687977
E02006359,Guildford 016,1734,685,165,32,2,2618,33.76623377
E02006360,Guildford 017,2022,949,276,45,1,3293,38.59702399
E02006361,Guildford 018,1473,664,162,26,2,2327,36.69961324
E02006362,Mole Valley 001,1629,851,236,23,3,2742,40.59080963
E02006363,Mole Valley 002,1424,697,200,48,10,2379,40.14291719
E02006364,Mole Valley 003,1711,1141,448,133,20,3453,50.44888503
E02006365,Mole Valley 004,1644,801,244,57,5,2751,40.23991276
E02006366,Mole Valley 005,1953,953,234,34,3,3177,38.52691218
E02006367,Mole Valley 006,1447,816,273,49,2,2587,44.06648628
E02006368,Mole Valley 007,1366,763,210,66,15,2420,43.55371901
E02006369,Mole Valley 008,1537,979,275,42,2,2835,45.78483245
E02006370,Mole Valley 009,1759,776,251,50,3,2839,38.04156393
E02006371,Mole Valley 010,1834,978,308,68,10,3198,42.65165729
E02006372,Mole Valley 011,1353,886,367,93,12,2711,50.09221689
E02006373,Mole Valley 012,1801,950,275,64,2,3092,41.75291074
E02006374,Mole Valley 013,1601,918,368,67,3,2957,45.85728779
E02006375,Reigate and Banstead 001,1594,746,199,22,2,2563,37.80725712
E02006376,Reigate and Banstead 002,1894,1085,327,37,6,3349,43.44580472
E02006377,Reigate and Banstead 003,1378,774,193,26,4,2375,41.97894737
E02006378,Reigate and Banstead 004,2029,1011,286,39,0,3365,39.70282318
E02006379,Reigate and Banstead 005,1336,950,393,126,7,2812,52.48933144
E02006380,Reigate and Banstead 006,1782,905,186,24,2,2899,38.53052777
E02006381,Reigate and Banstead 007,1704,905,249,25,5,2888,40.99722992
E02006382,Reigate and Banstead 008,1306,850,385,116,13,2670,51.08614232
E02006383,Reigate and Banstead 009,2651,1084,255,30,0,4020,34.05472637
E02006384,Reigate and Banstead 010,2419,1414,532,125,12,4502,46.26832519
E02006385,Reigate and Banstead 011,2850,1392,414,92,6,4754,40.0504838
E02006386,Reigate and Banstead 012,2152,888,248,38,3,3329,35.35596275
E02006387,Reigate and Banstead 013,1436,824,288,96,6,2650,45.81132075
E02006388,Reigate and Banstead 014,2079,1190,438,87,4,3798,45.26066351
E02006389,Reigate and Banstead 015,1463,967,329,72,12,2843,48.54027436
E02006390,Reigate and Banstead 016,2291,1252,426,107,4,4080,43.84803922
E02006391,Reigate and Banstead 017,1837,891,234,38,5,3005,38.86855241
E02006392,Reigate and Banstead 018,1947,1326,538,130,11,3952,50.73380567
E02006393,Runnymede 001,1448,971,371,53,3,2846,49.12157414
E02006394,Runnymede 002,1796,1178,436,76,5,3491,48.55342309
E02006395,Runnymede 003,1913,1353,507,108,4,3885,50.75933076
E02006396,Runnymede 004,1231,861,296,55,2,2445,49.65235174
E02006397,Runnymede 005,1610,696,153,25,3,2487,35.26336952
E02006398,Runnymede 006,2021,1180,471,106,10,3788,46.64730729
E02006399,Runnymede 007,2759,1617,607,127,7,5117,46.08168849
E02006400,Runnymede 008,1350,733,260,32,2,2377,43.2057215
E02006401,Runnymede 009,2271,1485,595,121,13,4485,49.36454849
E02006402,Runnymede 010,2205,1233,406,71,2,3917,43.70691856
E02006403,Spelthorne 001,1049,1016,470,149,26,2710,61.29151292
E02006404,Spelthorne 002,1174,995,463,122,11,2765,57.54068716
E02006405,Spelthorne 003,2409,1486,452,90,3,4440,45.74324324
E02006406,Spelthorne 004,2216,1252,433,101,7,4009,44.72437017
E02006407,Spelthorne 005,1827,1282,465,102,4,3680,50.35326087
E02006408,Spelthorne 006,1907,1229,471,93,5,3705,48.52901484
E02006409,Spelthorne 007,1243,908,442,110,3,2706,54.06504065
E02006410,Spelthorne 008,1529,1122,475,123,9,3258,53.06936771
E02006411,Spelthorne 009,1735,979,314,28,2,3058,43.26357096
E02006412,Spelthorne 010,1843,957,311,47,4,3162,41.714105
E02006413,Spelthorne 011,1350,863,349,66,3,2631,48.68871152
E02006414,Spelthorne 012,1350,840,281,64,4,2539,46.82946042
E02006415,Spelthorne 013,1658,1099,335,48,3,3143,47.24785237
E02006416,Surrey Heath 001,2191,1037,268,53,4,3553,38.33380242
E02006417,Surrey Heath 002,1453,826,235,64,7,2585,43.79110251
E02006418,Surrey Heath 003,1673,870,218,30,2,2793,40.10025063
E02006419,Surrey Heath 004,1528,1091,493,129,6,3247,52.94117647
E02006420,Surrey Heath 005,1940,917,202,28,1,3088,37.1761658
E02006421,Surrey Heath 006,2226,1039,269,37,5,3576,37.75167785
E02006422,Surrey Heath 007,1568,722,148,16,1,2455,36.13034623
E02006423,Surrey Heath 008,2354,1550,552,134,8,4598,48.80382775
E02006424,Surrey Heath 009,1500,720,196,17,0,2433,38.34771887
E02006425,Surrey Heath 010,1389,819,267,49,3,2527,45.03363672
E02006426,Surrey Heath 011,1378,666,184,25,1,2254,38.86424135
E02006427,Surrey Heath 012,1657,938,261,42,3,2901,42.88176491
E02006429,Tandridge 002,2222,1023,314,58,3,3620,38.61878453
E02006430,Tandridge 003,2069,1179,410,96,5,3759,44.95876563
E02006431,Tandridge 004,2613,1412,448,89,11,4573,42.86026678
E02006432,Tandridge 005,1282,726,237,51,7,2303,44.33347807
E02006433,Tandridge 006,2424,1120,297,32,1,3874,37.42901394
E02006434,Tandridge 007,1381,817,267,84,6,2555,45.94911937
E02006435,Tandridge 008,1393,760,266,70,5,2494,44.14595028
E02006436,Tandridge 009,1322,873,263,74,6,2538,47.91174153
E02006437,Tandridge 010,1885,1106,341,78,3,3413,44.76999707
E02006438,Tandridge 011,1772,1120,376,65,4,3337,46.89841175
E02006439,Waverley 001,1484,842,319,45,1,2691,44.85321442
E02006440,Waverley 002,1677,899,271,39,1,2887,41.9120194
E02006441,Waverley 003,2089,1125,406,104,6,3730,43.99463807
E02006442,Waverley 004,1547,708,124,20,0,2399,35.51479783
E02006443,Waverley 005,1668,1067,437,94,5,3271,49.00642006
E02006444,Waverley 006,1696,782,246,59,4,2787,39.14603516
E02006445,Waverley 007,2314,912,230,45,2,3503,33.94233514
E02006446,Waverley 008,1794,787,215,38,1,2835,36.71957672
E02006447,Waverley 009,1633,741,196,32,3,2605,37.31285988
E02006448,Waverley 010,1825,790,215,51,5,2886,36.76368676
E02006449,Waverley 011,1634,975,317,66,3,2995,45.44240401
E02006450,Waverley 012,1814,755,169,27,0,2765,34.39421338
E02006451,Waverley 013,2767,1624,432,82,4,4909,43.63414137
E02006453,Waverley 015,2024,1073,290,45,4,3436,41.09429569
E02006454,Waverley 016,1669,889,249,29,2,2838,41.19097956
E02006455,Waverley 017,1450,738,237,53,2,2480,41.53225806
E02006456,Woking 001,1683,1094,384,83,8,3252,48.24723247
E02006457,Woking 002,2430,1062,212,33,1,3738,34.99197432
E02006458,Woking 003,2249,1003,247,32,2,3533,36.34305123
E02006459,Woking 004,1397,1249,632,195,17,3490,59.9713467
E02006460,Woking 005,1950,1337,537,106,0,3930,50.38167939
E02006461,Woking 006,1674,848,218,24,2,2766,39.47939262
E02006462,Woking 007,1867,1080,343,79,8,3377,44.71424341
E02006463,Woking 008,2927,1519,476,104,13,5039,41.91307799
E02006464,Woking 009,1557,945,320,72,4,2898,46.27329193
E02006465,Woking 010,1577,710,167,31,4,2489,36.64122137
E02006466,Woking 011,2166,1261,563,144,17,4151,47.81980246
E02006467,Woking 012,1815,743,189,28,2,2777,34.64169968
E02006534,Adur 001,1634,1333,527,106,13,3613,54.77442569
E02006535,Adur 002,1659,1003,310,45,1,3018,45.02982107
E02006536,Adur 003,1349,1093,382,79,5,2908,53.61072902
E02006537,Adur 004,1807,1498,816,229,14,4364,58.59303391
E02006538,Adur 005,2317,1413,510,104,14,4358,46.83340982
E02006539,Adur 006,1245,1166,540,147,15,3113,60.00642467
E02006540,Adur 007,1028,986,493,94,11,2612,60.6431853
E02006541,Adur 008,1545,1380,616,131,20,3692,58.15276273
E02006542,Arun 001,1448,875,284,32,5,2644,45.23449319
E02006543,Arun 002,1249,877,306,54,4,2490,49.83935743
E02006544,Arun 003,2571,1564,496,101,4,4736,45.71368243
E02006545,Arun 004,2130,1685,748,205,20,4788,55.51378446
E02006546,Arun 005,2320,1602,666,109,9,4706,50.70123247
E02006547,Arun 006,1307,967,378,70,1,2723,52.00146897
E02006548,Arun 007,1994,1555,610,84,5,4248,53.06026365
E02006549,Arun 008,1499,1153,312,44,1,3009,50.18278498
E02006550,Arun 009,1821,1666,625,105,7,4224,56.88920455
E02006551,Arun 010,1920,1633,558,72,3,4186,54.1328237
E02006552,Arun 011,1379,1327,688,213,23,3630,62.01101928
E02006553,Arun 012,1940,1459,553,97,1,4050,52.09876543
E02006554,Arun 013,1453,1185,450,52,1,3141,53.74084686
E02006555,Arun 014,1267,1196,588,169,14,3234,60.82251082
E02006556,Arun 015,2323,1586,535,65,2,4511,48.50365773
E02006557,Arun 016,1186,1091,541,172,26,3016,60.67639257
E02006558,Arun 017,1803,1947,956,283,58,5047,64.27580741
E02006559,Arun 018,1891,1435,483,41,2,3852,50.9086189
E02006560,Arun 019,1870,1705,741,102,7,4425,57.74011299
E02006561,Chichester 001,1571,810,216,44,7,2648,40.67220544
E02006562,Chichester 002,1526,746,233,23,2,2530,39.68379447
E02006563,Chichester 003,1458,734,202,34,0,2428,39.95057661
E02006564,Chichester 004,2045,1307,388,74,2,3816,46.40985325
E02006565,Chichester 005,2031,1134,332,54,3,3554,42.85312324
E02006566,Chichester 006,2074,1206,333,58,1,3672,43.51851852
E02006567,Chichester 007,1911,1037,333,62,3,3346,42.88702929
E02006568,Chichester 008,2644,1781,749,208,10,5392,50.96439169
E02006569,Chichester 009,2189,1183,295,53,3,3723,41.20333065
E02006570,Chichester 010,2243,1445,528,121,10,4347,48.40119623
E02006571,Chichester 011,2102,1158,314,61,1,3636,42.18921892
E02006572,Chichester 012,2381,1630,581,131,7,4730,49.66173362
E02006573,Chichester 013,2670,1829,604,110,3,5216,48.81134969
E02006574,Chichester 014,2092,2016,808,147,14,5077,58.79456372
E02006575,Crawley 001,1162,1149,541,156,6,3014,61.44658261
E02006576,Crawley 002,2473,1279,379,56,7,4194,41.03481164
E02006577,Crawley 003,1498,1265,603,168,7,3541,57.69556622
E02006578,Crawley 004,2232,1828,787,171,21,5039,55.70549712
E02006579,Crawley 005,1612,1128,450,106,2,3298,51.12189206
E02006580,Crawley 006,1545,1134,467,113,5,3264,52.66544118
E02006581,Crawley 007,1840,1475,697,189,15,4216,56.35673624
E02006582,Crawley 008,1864,877,197,38,0,2976,37.3655914
E02006583,Crawley 009,1885,1296,530,93,6,3810,50.52493438
E02006584,Crawley 010,1131,1078,578,152,9,2948,61.63500678
E02006585,Crawley 011,1296,1106,545,130,5,3082,57.94938352
E02006586,Crawley 012,1068,979,489,119,10,2665,59.9249531
E02006587,Crawley 013,1328,1214,668,214,26,3450,61.50724638
E02006588,Horsham 001,2583,1316,444,128,15,4486,42.42086491
E02006589,Horsham 002,2841,1403,347,40,4,4635,38.70550162
E02006590,Horsham 003,2061,1246,425,71,8,3811,45.91970611
E02006591,Horsham 004,2007,1161,399,76,7,3650,45.01369863
E02006592,Horsham 005,1517,798,210,32,3,2560,40.7421875
E02006593,Horsham 006,2613,1728,714,169,11,5235,50.08595989
E02006594,Horsham 007,2679,1376,406,65,3,4529,40.84786929
E02006595,Horsham 008,2059,1062,212,24,2,3359,38.70199464
E02006596,Horsham 009,2243,1143,338,47,5,3776,40.59851695
E02006597,Horsham 010,2989,1581,501,78,6,5155,42.01745878
E02006598,Horsham 011,1312,723,197,23,2,2257,41.86973859
E02006599,Horsham 012,1877,987,220,20,1,3105,39.54911433
E02006600,Horsham 013,2409,1601,533,119,8,4670,48.41541756
E02006601,Horsham 014,2034,1333,443,80,6,3896,47.7926078
E02006602,Horsham 015,2058,1040,275,53,3,3429,39.98250219
E02006603,Horsham 016,2092,1303,376,42,2,3815,45.163827
E02006604,Mid Sussex 001,3055,2025,707,151,14,5952,48.67271505
E02006605,Mid Sussex 002,1389,838,222,24,2,2475,43.87878788
E02006606,Mid Sussex 003,2053,1061,263,33,2,3412,39.83001172
E02006607,Mid Sussex 004,1901,1030,255,32,0,3218,40.92604102
E02006608,Mid Sussex 005,1478,832,263,32,1,2606,43.28472755
E02006609,Mid Sussex 006,1653,828,223,31,2,2737,39.60540738
E02006610,Mid Sussex 007,1924,916,293,47,6,3186,39.61079724
E02006611,Mid Sussex 008,2900,1356,366,33,1,4656,37.71477663
E02006612,Mid Sussex 009,3191,1617,484,100,6,5398,40.88551315
E02006613,Mid Sussex 010,1753,1020,395,106,8,3282,46.58744668
E02006614,Mid Sussex 011,3190,1489,447,85,9,5220,38.88888889
E02006615,Mid Sussex 012,1637,876,234,35,0,2782,41.15744069
E02006616,Mid Sussex 013,2276,1296,401,83,3,4059,43.92707563
E02006617,Mid Sussex 014,1930,1382,611,139,6,4068,52.55653884
E02006618,Mid Sussex 015,1539,829,187,19,2,2576,40.25621118
E02006619,Mid Sussex 016,2005,1050,329,71,4,3459,42.03527031
E02006620,Mid Sussex 017,2425,1390,396,42,3,4256,43.02161654
E02006621,Worthing 001,1747,1215,349,47,2,3360,48.00595238
E02006622,Worthing 002,1642,1211,448,119,13,3433,52.1701136
E02006623,Worthing 003,1514,1243,546,144,10,3457,56.20480185
E02006624,Worthing 004,1688,886,253,32,5,2864,41.06145251
E02006625,Worthing 005,1690,1127,403,73,13,3306,48.88082275
E02006626,Worthing 006,1857,1264,610,174,8,3913,52.54280603
E02006627,Worthing 007,2098,1460,575,104,8,4245,50.57714959
E02006628,Worthing 008,1836,1383,542,172,27,3960,53.63636364
E02006629,Worthing 009,1444,1121,569,151,18,3303,56.28216773
E02006630,Worthing 010,1889,1695,718,193,28,4523,58.23568428
E02006631,Worthing 011,2306,1910,925,260,44,5445,57.64921947
E02006632,Worthing 012,2057,1303,465,63,4,3892,47.14799589
E02006633,Worthing 013,1884,1408,473,66,5,3836,50.88633994
E02006782,Bromley 040,1638,1064,391,101,3,3197,48.76446669
E02006783,Lewisham 037,1122,986,583,194,10,2895,61.24352332
E02006784,Lewisham 038,1209,1025,668,203,20,3125,61.312
E02006785,Bexley 029,1159,925,407,81,1,2573,54.95530509
E02006786,Greenwich 033,1222,998,476,164,14,2874,57.48086291
E02006787,Bromley 041,1812,882,322,74,3,3093,41.41610087
E02006788,Croydon 045,1340,947,455,149,6,2897,53.74525371
E02006789,Bromley 042,1392,1017,333,46,0,2788,50.07173601
E02006790,Tandridge 012,1575,1137,385,63,1,3161,50.17399557
E02006791,Ealing 040,2143,917,308,74,8,3450,37.88405797
E02006792,Hounslow 029,2430,1208,380,118,11,4147,41.40342416
E02006793,Enfield 037,921,1296,796,336,41,3390,72.83185841
E02006794,Haringey 037,901,1193,761,243,29,3127,71.18644068
E02006795,Harrow 032,1365,930,311,36,1,2643,48.35414302
E02006796,Hillingdon 033,1766,1197,508,97,10,3578,50.64281722
E02006798,Lewisham 039,1542,1381,655,186,11,3775,59.15231788
E02006799,Barking and Dagenham 023,1428,1379,787,285,11,3890,63.29048843
E02006800,Redbridge 034,1789,1758,756,199,12,4514,60.36774479
E02006801,Lambeth 036,1969,1157,450,127,8,3711,46.9415252
E02006802,Southwark 034,2000,1255,500,171,12,3938,49.21279837
E02006821,Portsmouth 026,1486,834,265,35,2,2622,43.32570557
E02006822,Havant 018,1887,1306,519,84,15,3811,50.48543689
E02006823,Buckinghamshire 039,2204,1029,260,36,1,3530,37.56373938
E02006824,Buckinghamshire 036,2229,1226,316,31,0,3802,41.3729616
E02006825,East Cambridgeshire 011,1599,843,251,37,0,2730,41.42857143
E02006826,West Suffolk 015,2404,1748,527,115,11,4805,49.96878252
E02006829,East Hampshire 016,1888,1009,273,36,1,3207,41.12878079
E02006830,Havant 019,1140,928,509,179,36,2792,59.16905444
E02006831,Havant 020,1382,971,308,30,2,2693,48.68176755
E02006832,Sevenoaks 016,1312,816,274,52,7,2461,46.68833807
E02006833,Tonbridge and Malling 014,2940,1566,505,130,7,5148,42.89044289
E02006836,Sutton 025,2024,934,216,37,1,3212,36.98630137
E02006837,Epsom and Ewell 010,2741,1289,347,61,1,4439,38.25185853
E02006838,East Hampshire 017,1767,984,217,27,2,2997,41.04104104
E02006839,Waverley 018,2144,992,257,38,2,3433,37.54733469
E02006853,Tower Hamlets 032,2744,1531,551,196,17,5039,45.54475094
E02006854,Tower Hamlets 033,2247,940,240,98,3,3528,36.30952381
E02006855,Canterbury 019,1177,855,379,133,9,2553,53.89737564
E02006856,Canterbury 020,2504,1691,623,156,8,4982,49.73906062
E02006857,Eastbourne 013,1700,1462,652,121,7,3942,56.8746829
E02006858,Eastbourne 014,1578,1188,414,86,4,3270,51.74311927
E02006859,Thurrock 019,1630,810,186,26,2,2654,38.58327054
E02006873,South Cambridgeshire 020,2272,916,260,64,0,3512,35.30751708
E02006874,South Cambridgeshire 021,2484,1132,329,77,6,4028,38.33167825
E02006877,Peterborough 022,2418,1394,466,99,5,4382,44.81971702
E02006878,Peterborough 023,2731,1283,459,134,7,4614,40.81057651
E02006879,Folkestone and Hythe 014,1227,1203,750,309,55,3544,65.37810384
E02006880,Folkestone and Hythe 015,1595,1213,546,141,11,3506,54.50656018
E02006882,Harrow 033,2158,1591,550,93,7,4399,50.94339623
E02006886,Vale of White Horse 016,3516,1612,436,66,5,5635,37.60425909
E02006907,Norwich 014,2252,1365,524,154,13,4308,47.72516249
E02006908,Norwich 015,1520,938,426,128,6,3018,49.63552021
E02006918,Hackney 028,1212,1116,598,231,13,3170,61.76656151
E02006921,Hackney 029,896,1095,541,234,16,2782,67.79295471
E02006922,Colchester 022,2715,2098,873,191,9,5886,53.87359837
E02006924,Redbridge 035,1816,1508,644,122,6,4096,55.6640625
E02006925,Redbridge 036,1998,1487,568,132,3,4188,52.29226361
E02006926,Thurrock 020,1694,884,227,37,1,2843,40.41505452
E02006927,Greenwich 034,2754,1483,625,216,8,5086,45.85135667
E02006928,Greenwich 035,3263,1314,504,172,12,5265,38.02469136
E02006930,Greenwich 037,2567,1147,386,112,14,4226,39.2569806
E02006931,Greenwich 038,2352,1214,439,118,14,4137,43.14720812
E02006937,Luton 022,1616,1512,694,201,18,4041,60.00989854
E02006938,Luton 023,833,1191,692,218,28,2962,71.87711006
E02006939,Reading 019,1814,1071,375,109,10,3379,46.31547795
E02006940,Reading 020,2009,1070,409,107,11,3606,44.28729895
E02006941,Southwark 035,2064,762,132,26,1,2985,30.85427136
E02006942,Southwark 036,1969,920,343,122,10,3364,41.46848989
E02006953,Barnet 042,1950,1239,494,157,15,3855,49.41634241
E02006954,Barnet 043,1801,1237,503,150,29,3720,51.58602151
E02006955,Brent 035,1512,816,299,78,4,2709,44.18604651
E02006956,Brent 036,1070,927,393,109,6,2505,57.28542914
E02006968,Ealing 041,2001,1087,363,100,9,3560,43.79213483
E02006969,Ealing 042,1639,934,321,74,8,2976,44.92607527
E02006970,Ealing 043,556,795,506,157,14,2028,72.58382643
E02006971,Ealing 044,583,945,513,172,9,2222,73.76237624
E02006972,Hounslow 030,1131,729,355,109,10,2334,51.54241645
E02006973,Hounslow 031,1669,1268,582,188,19,3726,55.20665593
E02006975,Portsmouth 027,1000,911,518,208,17,2654,62.32102487
E02006976,Portsmouth 028,552,821,614,277,28,2292,75.91623037
E02006978,Chelmsford 022,1969,1007,308,67,5,3356,41.32896305
E02006979,Chelmsford 023,2022,954,292,77,4,3349,39.62376829
E02006980,Rochford 011,1583,1032,333,34,1,2983,46.93261817
E02006981,Rochford 012,1675,1111,440,61,2,3289,49.07266646
E02006987,Croydon 046,2062,1262,461,82,12,3879,46.84196958
E02006988,Croydon 047,1497,1208,469,113,18,3305,54.70499244
E02006991,Greenwich 039,2172,803,207,47,2,3231,32.77623027
E02006992,Greenwich 040,2262,982,388,135,3,3770,40
E02006993,Greenwich 041,2242,958,330,90,6,3626,38.16878103
E02006994,Greenwich 042,1321,1243,537,174,10,3285,59.7869102
E02006995,Newham 038,2179,727,247,80,4,3237,32.68458449
E02006996,Newham 039,1771,907,371,101,8,3158,43.92020266
E02006997,Newham 040,1832,977,306,107,7,3229,43.26416847
E02006998,Newham 041,1037,1011,450,159,11,2668,61.13193403
E02006999,Newham 042,3288,1321,338,99,3,5049,34.8781937
E02007004,Thurrock 021,1224,954,376,86,9,2649,53.79388448
E02007005,Thurrock 022,1622,1017,380,89,5,3113,47.89592033
E02007008,Lewisham 040,1536,780,276,66,3,2661,42.27733935
E02007009,Lewisham 041,1671,1384,698,208,26,3987,58.08878856
E02007010,Bedford 021,1899,1142,360,58,4,3463,45.16315334
E02007011,Bedford 022,1653,800,267,49,2,2771,40.34644533
E02007012,Milton Keynes 033,1839,839,264,55,3,3000,38.7
E02007013,Milton Keynes 034,2322,879,225,62,3,3491,33.48610713
E02007014,Milton Keynes 035,1525,953,256,82,9,2825,46.01769912
E02007015,Milton Keynes 036,2398,998,273,64,4,3737,35.83088039
E02007016,Milton Keynes 037,2002,889,292,62,1,3246,38.32409119
E02007017,Redbridge 037,1294,986,393,87,3,2763,53.16684763
E02007018,Redbridge 038,1129,898,381,112,6,2526,55.30482977
E02007019,Redbridge 039,856,945,461,132,10,2404,64.39267887
E02007020,Redbridge 040,997,1020,569,129,9,2724,63.39941263
E02007021,Oxford 020,1294,855,393,125,7,2674,51.60807779
E02007032,North Norfolk 015,1341,1247,535,115,12,3250,58.73846154
E02007033,North Norfolk 016,1275,1054,459,93,5,2886,55.82120582
E02007046,Ashford 015,1277,1013,503,126,6,2925,56.34188034
E02007047,Ashford 016,1929,1065,299,68,4,3365,42.67459138
E02007052,Norwich 016,1419,1244,738,288,11,3700,61.64864865
E02007053,Norwich 017,1360,935,435,164,8,2902,53.13576844
E02007054,South Norfolk 016,2062,1119,298,63,2,3544,41.81715576
E02007055,South Norfolk 017,1508,1321,511,95,3,3438,56.13728912
E02007056,Colchester 023,2165,844,304,70,4,3387,36.07912607
E02007057,Colchester 024,1838,926,252,57,2,3075,40.22764228
E02007068,Slough 015,1005,856,381,97,4,2343,57.10627401
E02007069,Slough 016,887,886,422,98,5,2298,61.40121845
E02007074,Southampton 033,1174,1076,534,206,22,3012,61.02257636
E02007075,Southampton 034,2062,758,191,34,4,3049,32.37126927
E02007076,Test Valley 016,1825,797,278,89,3,2992,39.0040107
E02007077,Test Valley 017,1717,815,248,71,2,2853,39.81773572
E02007078,Test Valley 018,1055,898,389,113,5,2460,57.11382114
E02007083,Wandsworth 038,2737,1054,251,60,4,4106,33.34145153
E02007084,Wandsworth 039,1905,1338,652,224,17,4136,53.9410058
E02007085,South Cambridgeshire 022,2893,1631,417,45,1,4987,41.98917185
E02007086,Cambridge 015,2730,1113,351,78,3,4275,36.14035088
E02007087,Cambridge 014,1404,762,204,56,8,2434,42.31717338
E02007088,North Hertfordshire 016,1901,945,275,39,0,3160,39.84177215
E02007089,North Hertfordshire 017,1694,827,245,48,0,2814,39.80099502
E02007090,St Albans 021,1322,715,252,74,3,2366,44.12510566
E02007091,Stevenage 013,1524,836,284,39,6,2689,43.32465601
E02007092,Welwyn Hatfield 017,1062,817,344,65,6,2294,53.70531822
E02007093,East Hertfordshire 019,1897,1038,299,60,1,3295,42.42792109
E02007108,Hackney 030,1600,820,282,86,14,2802,42.89793005
E02007109,Hackney 031,1642,968,478,190,26,3304,50.30266344
E02007110,Hackney 032,1738,987,457,162,19,3363,48.31995242
E02007111,Hackney 033,1658,812,275,63,8,2816,41.12215909
E02007112,Tower Hamlets 034,1763,898,180,72,2,2915,39.51972556
E02007113,Tower Hamlets 035,1907,940,304,112,5,3268,41.64626683
E02007114,Tower Hamlets 036,1532,993,363,135,9,3032,49.47229551
E02007115,Camden 029,1683,1608,837,314,25,4467,62.32370719
E02007116,Oxford 019,1379,907,352,111,3,2752,49.89098837